,Gen,start,end,isProtine,strand,len,name
1,gene,409,1750,gene,1,1341,dnaA
2,CDS,409,1750,CDS,1,1341,dnaN
3,gene,1938,3075,gene,1,1137,dnaN
4,CDS,1938,3075,CDS,1,1137,rlbA
5,gene,3205,3421,gene,1,216,rlbA
6,CDS,3205,3421,CDS,1,216,recF
7,gene,3436,4549,gene,1,1113,recF
8,CDS,3436,4549,CDS,1,1113,remB
10,CDS,4566,4812,CDS,1,246,gyrB
9,gene,4566,4812,gene,1,246,remB
11,gene,4866,6783,gene,1,1917,gyrB
12,CDS,4866,6783,CDS,1,1917,gyrA
13,gene,6993,9459,gene,1,2466,gyrA
14,CDS,6993,9459,CDS,1,2466,rrnO-16S
15,gene,9809,11364,gene,1,1555,rrnO-16S
16,rRNA,9809,11364,else,1,1555,trnO-Ile
18,tRNA,11463,11540,else,1,77,trnO-Ala
17,gene,11463,11540,gene,1,77,trnO-Ile
19,gene,11551,11627,gene,1,76,trnO-Ala
20,tRNA,11551,11627,else,1,76,rrnO-23S
21,gene,11708,14636,gene,1,2928,rrnO-23S
22,rRNA,11708,14636,else,1,2928,rrnO-5S
23,gene,14691,14810,gene,1,119,rrnO-5S
24,rRNA,14691,14810,else,1,119,yaaC
25,gene,14846,15794,gene,-1,948,yaaC
26,CDS,14846,15794,CDS,-1,948,guaB
27,gene,15914,17381,gene,1,1467,guaB
28,CDS,15914,17381,CDS,1,1467,dacA
29,gene,17533,18865,gene,1,1332,dacA
30,CDS,17533,18865,CDS,1,1332,pdxS
31,gene,19061,19946,gene,1,885,pdxS
32,CDS,19061,19946,CDS,1,885,pdxT
33,gene,19967,20558,gene,1,591,pdxT
34,CDS,19967,20558,CDS,1,591,tboS
36,misc_RNA,20610,20823,else,1,213,serS
35,gene,20610,20823,gene,1,213,tboS
37,gene,20879,22157,gene,1,1278,serS
38,CDS,20879,22157,CDS,1,1278,trnSL-Ser1
39,gene,22291,22384,gene,1,93,trnSL-Ser1
40,tRNA,22291,22384,else,1,93,dck
41,gene,22495,23149,gene,-1,654,dck
42,CDS,22495,23149,CDS,-1,654,dgk
44,CDS,23145,23769,CDS,-1,624,sleL
43,gene,23145,23769,gene,-1,624,dgk
45,gene,23867,25151,gene,-1,1284,sleL
46,CDS,23867,25151,CDS,-1,1284,yaaI
47,gene,25220,25766,gene,-1,546,yaaI
48,CDS,25220,25766,CDS,-1,546,tadA
49,gene,25851,26337,gene,1,486,tadA
50,CDS,25851,26337,CDS,1,486,scr
51,gene,26378,26732,gene,1,354,scr
52,misc_RNA,26378,26732,else,1,354,dnaX
54,CDS,26813,28505,CDS,1,1692,ebfC
53,gene,26813,28505,gene,1,1692,dnaX
55,gene,28528,28852,gene,1,324,ebfC
56,CDS,28528,28852,CDS,1,324,recR
57,gene,28866,29463,gene,1,597,recR
58,CDS,28866,29463,CDS,1,597,yaaL
59,gene,29480,29705,gene,1,225,yaaL
60,CDS,29480,29705,CDS,1,225,bofA
61,gene,29771,30035,gene,1,264,bofA
62,CDS,29771,30035,CDS,1,264,rrnA-16S
63,gene,30278,31832,gene,1,1554,rrnA-16S
64,rRNA,30278,31832,else,1,1554,trnA-Ile
65,gene,31931,32008,gene,1,77,trnA-Ile
66,tRNA,31931,32008,else,1,77,trnA-Ala
67,gene,32019,32095,gene,1,76,trnA-Ala
68,tRNA,32019,32095,else,1,76,rrnA-23S
70,rRNA,32176,35103,else,1,2927,rrnA-5S
69,gene,32176,35103,gene,1,2927,rrnA-23S
72,rRNA,35236,35355,else,1,119,csfB
71,gene,35236,35355,gene,1,119,rrnA-5S
73,gene,35530,35725,gene,1,195,csfB
74,CDS,35530,35725,CDS,1,195,xpaC
75,gene,35844,36459,gene,1,615,xpaC
76,CDS,35844,36459,CDS,1,615,yaaN
77,gene,36477,37638,gene,1,1161,yaaN
78,CDS,36477,37638,CDS,1,1161,yaaO
79,gene,37719,39162,gene,1,1443,yaaO
80,CDS,37719,39162,CDS,1,1443,tmk
81,gene,39158,39797,gene,1,639,tmk
82,CDS,39158,39797,CDS,1,639,darA
83,gene,39870,40200,gene,1,330,darA
84,CDS,39870,40200,CDS,1,330,yaaR
85,gene,40212,40653,gene,1,441,yaaR
86,CDS,40212,40653,CDS,1,441,holB
87,gene,40664,41654,gene,1,990,holB
88,CDS,40664,41654,CDS,1,990,ricT
90,CDS,41656,42484,CDS,1,828,dnaH
89,gene,41656,42484,gene,1,828,ricT
91,gene,42498,42858,gene,1,360,dnaH
92,CDS,42498,42858,CDS,1,360,trmNF
93,gene,42916,43660,gene,1,744,trmNF
94,CDS,42916,43660,CDS,1,744,yazA
95,gene,43646,43946,gene,1,300,yazA
96,CDS,43646,43946,CDS,1,300,rsmI
98,CDS,43920,44799,CDS,1,879,abrB
97,gene,43920,44799,gene,1,879,rsmI
99,gene,44847,45138,gene,-1,291,abrB
100,CDS,44847,45138,CDS,-1,291,metS
101,gene,45632,47627,gene,1,1995,metS
102,CDS,45632,47627,CDS,1,1995,dayD
103,gene,47705,48473,gene,1,768,dayD
104,CDS,47705,48473,CDS,1,768,yabE
106,CDS,48628,49942,CDS,1,1314,rnmV
105,gene,48628,49942,gene,1,1314,yabE
108,CDS,50086,50647,CDS,1,561,rsmA
107,gene,50086,50647,gene,1,561,rnmV
109,gene,50639,51518,gene,1,879,rsmA
110,CDS,50639,51518,CDS,1,879,prtG
111,gene,51679,52552,gene,1,873,prtG
112,CDS,51679,52552,CDS,1,873,veg
113,gene,52762,53023,gene,1,261,veg
114,CDS,52762,53023,CDS,1,261,sspF
115,gene,53182,53368,gene,1,186,sspF
116,CDS,53182,53368,CDS,1,186,ispE
118,CDS,53515,54385,CDS,1,870,purR
117,gene,53515,54385,gene,1,870,ispE
119,gene,54440,55298,gene,1,858,purR
120,CDS,54440,55298,CDS,1,858,ridA
121,gene,55294,55672,gene,1,378,ridA
122,CDS,55294,55672,CDS,1,378,spoVG
123,gene,55865,56159,gene,1,294,spoVG
124,CDS,55865,56159,CDS,1,294,glmU
126,CDS,56351,57722,CDS,1,1371,prs
125,gene,56351,57722,gene,1,1371,glmU
127,gene,57744,58698,gene,1,954,prs
128,CDS,57744,58698,CDS,1,954,ctc
129,gene,58782,59397,gene,1,615,ctc
130,CDS,58782,59397,CDS,1,615,pth
131,gene,59503,60070,gene,1,567,pth
132,CDS,59503,60070,CDS,1,567,fin
133,gene,60129,60360,gene,1,231,fin
134,CDS,60129,60360,CDS,1,231,mfd
135,gene,60429,63963,gene,1,3534,mfd
136,CDS,60429,63963,CDS,1,3534,spoVT
137,gene,64098,64635,gene,1,537,spoVT
138,CDS,64098,64635,CDS,1,537,yabM
139,gene,64816,66415,gene,1,1599,yabM
140,CDS,64816,66415,CDS,1,1599,yabN
142,CDS,66404,67874,CDS,1,1470,hslR
141,gene,66404,67874,gene,1,1470,yabN
143,gene,67876,68137,gene,1,261,hslR
144,CDS,67876,68137,CDS,1,261,spcP
145,gene,68215,68518,gene,1,303,spcP
146,CDS,68215,68518,CDS,1,303,spcQ
147,gene,68514,69150,gene,1,636,spcQ
148,CDS,68514,69150,CDS,1,636,divIC
149,gene,69167,69545,gene,1,378,divIC
150,CDS,69167,69545,CDS,1,378,yabR
151,gene,69625,70012,gene,1,387,yabR
152,CDS,69625,70012,CDS,1,387,trnSL-Met1
153,gene,70180,70257,gene,1,77,trnSL-Met1
154,tRNA,70180,70257,else,1,77,trnSL-Glu1
155,gene,70266,70338,gene,1,72,trnSL-Glu1
156,tRNA,70266,70338,else,1,72,spoIIE
158,CDS,70537,73021,CDS,1,2484,yabS
157,gene,70537,73021,gene,1,2484,spoIIE
159,gene,73105,73843,gene,1,738,yabS
160,CDS,73105,73843,CDS,1,738,prkT
161,gene,73808,74825,gene,1,1017,prkT
162,CDS,73808,74825,CDS,1,1017,tilS
163,gene,74928,76347,gene,1,1419,tilS
164,CDS,74928,76347,CDS,1,1419,hprT
166,CDS,76343,76886,CDS,1,543,ftsH
165,gene,76343,76886,gene,1,543,hprT
167,gene,76983,78897,gene,1,1914,ftsH
168,CDS,76983,78897,CDS,1,1914,coaX
169,gene,79091,79868,gene,1,777,coaX
170,CDS,79091,79868,CDS,1,777,hslO
171,gene,79879,80755,gene,1,876,hslO
172,CDS,79879,80755,CDS,1,876,yacD
173,gene,80801,81695,gene,1,894,yacD
174,CDS,80801,81695,CDS,1,894,cysK
176,CDS,81770,82697,CDS,1,927,pabB
175,gene,81770,82697,gene,1,927,cysK
177,gene,82863,84276,gene,1,1413,pabB
178,CDS,82863,84276,CDS,1,1413,pabA
179,gene,84289,84874,gene,1,585,pabA
180,CDS,84289,84874,CDS,1,585,pabC
181,gene,84873,85755,gene,1,882,pabC
182,CDS,84873,85755,CDS,1,882,folP
184,CDS,85736,86594,CDS,1,858,folB
183,gene,85736,86594,gene,1,858,folP
185,gene,86586,86949,gene,1,363,folB
186,CDS,86586,86949,CDS,1,363,folK
187,gene,86945,87449,gene,1,504,folK
188,CDS,86945,87449,CDS,1,504,yazB
189,gene,87400,87610,gene,1,210,yazB
190,CDS,87400,87610,CDS,1,210,dusB
191,gene,87633,88635,gene,1,1002,dusB
192,CDS,87633,88635,CDS,1,1002,lysS
194,CDS,88726,90226,CDS,1,1500,rrnJ-16S
193,gene,88726,90226,gene,1,1500,lysS
195,gene,90535,92089,gene,1,1554,rrnJ-16S
196,rRNA,90535,92089,else,1,1554,rrnJ-23S
197,gene,92253,95181,gene,1,2928,rrnJ-23S
198,rRNA,92253,95181,else,1,2928,rrnJ-5S
199,gene,95236,95354,gene,1,118,rrnJ-5S
200,rRNA,95236,95354,else,1,118,trnJ-Val
201,gene,95374,95450,gene,1,76,trnJ-Val
202,tRNA,95374,95450,else,1,76,trnJ-Thr
203,gene,95454,95530,gene,1,76,trnJ-Thr
204,tRNA,95454,95530,else,1,76,trnJ-Lys
205,gene,95566,95642,gene,1,76,trnJ-Lys
206,tRNA,95566,95642,else,1,76,trnJ-Leu1
207,gene,95648,95731,gene,1,83,trnJ-Leu1
208,tRNA,95648,95731,else,1,83,trnJ-Gly
209,gene,95771,95846,gene,1,75,trnJ-Gly
210,tRNA,95771,95846,else,1,75,trnJ-Leu2
212,tRNA,95860,95946,else,1,86,trnJ-Arg
211,gene,95860,95946,gene,1,86,trnJ-Leu2
213,gene,95955,96032,gene,1,77,trnJ-Arg
214,tRNA,95955,96032,else,1,77,trnJ-Pro
215,gene,96059,96136,gene,1,77,trnJ-Pro
216,tRNA,96059,96136,else,1,77,trnJ-Ala
217,gene,96145,96221,gene,1,76,trnJ-Ala
218,tRNA,96145,96221,else,1,76,rrnW-16S
220,rRNA,96391,97945,else,1,1554,rrnW-23S
219,gene,96391,97945,gene,1,1554,rrnW-16S
221,gene,98109,101037,gene,1,2928,rrnW-23S
222,rRNA,98109,101037,else,1,2928,rrnW-5S
223,gene,101092,101211,gene,1,119,rrnW-5S
224,rRNA,101092,101211,else,1,119,ctsR
225,gene,101448,101913,gene,1,465,ctsR
226,CDS,101448,101913,CDS,1,465,mcsA
228,CDS,101926,102484,CDS,1,558,mcsB
227,gene,101926,102484,gene,1,558,mcsA
230,CDS,102483,103575,CDS,1,1092,clpC
229,gene,102483,103575,gene,1,1092,mcsB
231,gene,103571,106004,gene,1,2433,clpC
232,CDS,103571,106004,CDS,1,2433,radA
233,gene,106095,107472,gene,1,1377,radA
234,CDS,106095,107472,CDS,1,1377,disA
235,gene,107475,108558,gene,1,1083,disA
236,CDS,107475,108558,CDS,1,1083,yacL
237,gene,108673,109774,gene,1,1101,yacL
238,CDS,108673,109774,CDS,1,1101,ispD
240,CDS,109788,110487,CDS,1,699,ispF
239,gene,109788,110487,gene,1,699,ispD
241,gene,110479,110956,gene,1,477,ispF
242,CDS,110479,110956,CDS,1,477,gltX
243,gene,111046,112498,gene,1,1452,gltX
244,CDS,111046,112498,CDS,1,1452,cysE
245,gene,112799,113453,gene,1,654,cysE
246,CDS,112799,113453,CDS,1,654,cysS
248,CDS,113449,114850,CDS,1,1401,mrnC
247,gene,113449,114850,gene,1,1401,cysS
249,gene,114853,115285,gene,1,432,mrnC
250,CDS,114853,115285,CDS,1,432,rlmB
251,gene,115268,116018,gene,1,750,rlmB
252,CDS,115268,116018,CDS,1,750,raeA
253,gene,116024,116537,gene,1,513,raeA
254,CDS,116024,116537,CDS,1,513,sigH
255,gene,116599,117256,gene,1,657,sigH
256,CDS,116599,117256,CDS,1,657,rpmGB
257,gene,117348,117498,gene,1,150,rpmGB
258,CDS,117348,117498,CDS,1,150,secE
259,gene,117531,117711,gene,1,180,secE
260,CDS,117531,117711,CDS,1,180,nusG
261,gene,117889,118423,gene,1,534,nusG
262,CDS,117889,118423,CDS,1,534,rplK
264,CDS,118590,119016,CDS,1,426,rplA
263,gene,118590,119016,gene,1,426,rplK
265,gene,119110,119809,gene,1,699,rplA
266,CDS,119110,119809,CDS,1,699,ldlJ
267,gene,119854,119995,gene,1,141,ldlJ
268,misc_RNA,119854,119995,else,1,141,rplJ
269,gene,120060,120561,gene,1,501,rplJ
270,CDS,120060,120561,CDS,1,501,rplL
272,CDS,120606,120978,CDS,1,372,rlmG
271,gene,120606,120978,gene,1,372,rplL
273,gene,121067,121673,gene,1,606,rlmG
274,CDS,121067,121673,CDS,1,606,rpoB
275,gene,121918,125500,gene,1,3582,rpoB
276,CDS,121918,125500,CDS,1,3582,rpoC
277,gene,125561,129161,gene,1,3600,rpoC
278,CDS,125561,129161,CDS,1,3600,rulS
279,gene,129339,129588,gene,1,249,rulS
280,CDS,129339,129588,CDS,1,249,rpsL
281,gene,129701,130118,gene,1,417,rpsL
282,CDS,129701,130118,CDS,1,417,rpsG
284,CDS,130159,130630,CDS,1,471,fusA
283,gene,130159,130630,gene,1,471,rpsG
285,gene,130683,132762,gene,1,2079,fusA
286,CDS,130683,132762,CDS,1,2079,tufA
287,gene,132881,134072,gene,1,1191,tufA
288,CDS,132881,134072,CDS,1,1191,ybaC
289,gene,134170,135127,gene,1,957,ybaC
290,CDS,134170,135127,CDS,1,957,rpsJ
291,gene,135363,135672,gene,1,309,rpsJ
292,CDS,135363,135672,CDS,1,309,rplC
293,gene,135711,136341,gene,1,630,rplC
294,CDS,135711,136341,CDS,1,630,rplD
295,gene,136368,136992,gene,1,624,rplD
296,CDS,136368,136992,CDS,1,624,rplW
297,gene,136991,137279,gene,1,288,rplW
298,CDS,136991,137279,CDS,1,288,rplB
300,CDS,137310,138144,CDS,1,834,rpsS
299,gene,137310,138144,gene,1,834,rplB
301,gene,138201,138480,gene,1,279,rpsS
302,CDS,138201,138480,CDS,1,279,rplV
303,gene,138496,138838,gene,1,342,rplV
304,CDS,138496,138838,CDS,1,342,rpsC
305,gene,138841,139498,gene,1,657,rpsC
306,CDS,138841,139498,CDS,1,657,rplP
308,CDS,139499,139934,CDS,1,435,rpmC
307,gene,139499,139934,gene,1,435,rplP
309,gene,139923,140124,gene,1,201,rpmC
310,CDS,139923,140124,CDS,1,201,rpsQ
311,gene,140146,140410,gene,1,264,rpsQ
312,CDS,140146,140410,CDS,1,264,rplNA
313,gene,140450,140819,gene,1,369,rplNA
314,CDS,140450,140819,CDS,1,369,rplX
315,gene,140856,141168,gene,1,312,rplX
316,CDS,140856,141168,CDS,1,312,rplE
318,CDS,141194,141734,CDS,1,540,rpsNA
317,gene,141194,141734,gene,1,540,rplE
319,gene,141756,141942,gene,1,186,rpsNA
320,CDS,141756,141942,CDS,1,186,rpsH
321,gene,141973,142372,gene,1,399,rpsH
322,CDS,141973,142372,CDS,1,399,rplF
323,gene,142401,142941,gene,1,540,rplF
324,CDS,142401,142941,CDS,1,540,rplR
326,CDS,142973,143336,CDS,1,363,rpsE
325,gene,142973,143336,gene,1,363,rplR
327,gene,143360,143861,gene,1,501,rpsE
328,CDS,143360,143861,CDS,1,501,rpmD
329,gene,143874,144054,gene,1,180,rpmD
330,CDS,143874,144054,CDS,1,180,rplO
331,gene,144084,144525,gene,1,441,rplO
332,CDS,144084,144525,CDS,1,441,secY
333,gene,144526,145822,gene,1,1296,secY
334,CDS,144526,145822,CDS,1,1296,adk
336,CDS,145876,146530,CDS,1,654,mapA
335,gene,145876,146530,gene,1,654,adk
337,gene,146526,147273,gene,1,747,mapA
338,CDS,146526,147273,CDS,1,747,ybzG
339,gene,147311,147536,gene,1,225,ybzG
340,CDS,147311,147536,CDS,1,225,infA
341,gene,147584,147803,gene,1,219,infA
342,CDS,147584,147803,CDS,1,219,rpmJ
343,gene,147836,147950,gene,1,114,rpmJ
344,CDS,147836,147950,CDS,1,114,rpsM
345,gene,147972,148338,gene,1,366,rpsM
346,CDS,147972,148338,CDS,1,366,rpsK
347,gene,148358,148754,gene,1,396,rpsK
348,CDS,148358,148754,CDS,1,396,rpoA
349,gene,148930,149875,gene,1,945,rpoA
350,CDS,148930,149875,CDS,1,945,rplQ
351,gene,149952,150315,gene,1,363,rplQ
352,CDS,149952,150315,CDS,1,363,ecfA
354,CDS,150442,151288,CDS,1,846,ecfAB
353,gene,150442,151288,gene,1,846,ecfA
355,gene,151302,152133,gene,1,831,ecfAB
356,CDS,151302,152133,CDS,1,831,ecfT
357,gene,152129,152927,gene,1,798,ecfT
358,CDS,152129,152927,CDS,1,798,truA
359,gene,152936,153680,gene,1,744,truA
360,CDS,152936,153680,CDS,1,744,ldlM
362,misc_RNA,153736,153793,else,1,57,rplM
361,gene,153736,153793,gene,1,57,ldlM
363,gene,153841,154279,gene,1,438,rplM
364,CDS,153841,154279,CDS,1,438,rpsI
365,gene,154299,154692,gene,1,393,rpsI
366,CDS,154299,154692,CDS,1,393,ybaJ
367,gene,155155,155923,gene,1,768,ybaJ
368,CDS,155155,155923,CDS,1,768,ybaK
370,CDS,156108,156552,CDS,1,444,cwlD
369,gene,156108,156552,gene,1,444,ybaK
372,CDS,156611,157325,CDS,1,714,salA
371,gene,156611,157325,gene,1,714,cwlD
373,gene,157420,158479,gene,1,1059,salA
374,CDS,157420,158479,CDS,1,1059,gerD
375,gene,158514,159072,gene,-1,558,gerD
376,CDS,158514,159072,CDS,-1,558,kbaA
377,gene,159181,159778,gene,1,597,kbaA
378,CDS,159181,159778,CDS,1,597,pdaB
379,gene,159778,160543,gene,-1,765,pdaB
380,CDS,159778,160543,CDS,-1,765,rrnI-16S
382,rRNA,160892,162445,else,1,1553,rrnI-23S
381,gene,160892,162445,gene,1,1553,rrnI-16S
383,gene,162609,165535,gene,1,2926,rrnI-23S
384,rRNA,162609,165535,else,1,2926,rrnI-5S
385,gene,165590,165707,gene,1,117,rrnI-5S
386,rRNA,165590,165707,else,1,117,trnI-Asn
387,gene,165753,165825,gene,1,72,trnI-Asn
388,tRNA,165753,165825,else,1,72,trnI-Thr
390,tRNA,165829,165902,else,1,73,trnI-Gly
389,gene,165829,165902,gene,1,73,trnI-Thr
391,gene,165958,166033,gene,1,75,trnI-Gly
392,tRNA,165958,166033,else,1,75,trnI-Arg
393,gene,166063,166140,gene,1,77,trnI-Arg
394,tRNA,166063,166140,else,1,77,trnI-Pro
395,gene,166167,166244,gene,1,77,trnI-Pro
396,tRNA,166167,166244,else,1,77,trnI-Ala
397,gene,166252,166328,gene,1,76,trnI-Ala
398,tRNA,166252,166328,else,1,76,rrnH-16S
399,gene,166499,168053,gene,1,1554,rrnH-16S
400,rRNA,166499,168053,else,1,1554,rrnH-23S
401,gene,168217,171141,gene,1,2924,rrnH-23S
402,rRNA,168217,171141,else,1,2924,rrnH-5S
403,gene,171196,171314,gene,1,118,rrnH-5S
404,rRNA,171196,171314,else,1,118,rrnG-16S
406,rRNA,171497,173049,else,1,1552,rrnG-23S
405,gene,171497,173049,gene,1,1552,rrnG-16S
407,gene,173213,176141,gene,1,2928,rrnG-23S
408,rRNA,173213,176141,else,1,2928,rrnG-5S
409,gene,176196,176315,gene,1,119,rrnG-5S
410,rRNA,176196,176315,else,1,119,ybaR
411,gene,177082,178519,gene,1,1437,ybaR
412,CDS,177082,178519,CDS,1,1437,ybaS
414,CDS,178664,179585,CDS,1,921,eesA
413,gene,178664,179585,gene,1,921,ybaS
415,gene,179594,180347,gene,-1,753,eesA
416,CDS,179594,180347,CDS,-1,753,feuC
417,gene,180343,181354,gene,-1,1011,feuC
418,CDS,180343,181354,CDS,-1,1011,feuB
419,gene,181346,182351,gene,-1,1005,feuB
420,CDS,181346,182351,CDS,-1,1005,feuA
421,gene,182369,183323,gene,-1,954,feuA
422,CDS,182369,183323,CDS,-1,954,btr
424,CDS,183413,185003,CDS,-1,1590,ybbC
423,gene,183413,185003,gene,-1,1590,btr
426,CDS,185193,186438,CDS,-1,1245,nagZ
425,gene,185193,186438,gene,-1,1245,ybbC
427,gene,186451,188380,gene,-1,1929,nagZ
428,CDS,186451,188380,CDS,-1,1929,amiE
429,gene,188407,189733,gene,-1,1326,amiE
430,CDS,188407,189733,CDS,-1,1326,murP
431,gene,189789,191157,gene,-1,1368,murP
432,CDS,189789,191157,CDS,-1,1368,murR
433,gene,191182,192034,gene,-1,852,murR
434,CDS,191182,192034,CDS,-1,852,murQ
435,gene,192050,192965,gene,-1,915,murQ
436,CDS,192050,192965,CDS,-1,915,ybbJ
437,gene,193074,193557,gene,-1,483,ybbJ
438,CDS,193074,193557,CDS,-1,483,ybbK
439,gene,193569,194025,gene,-1,456,ybbK
440,CDS,193569,194025,CDS,-1,456,trnSL-Glu2
441,gene,194204,194279,gene,1,75,trnSL-Glu2
442,tRNA,194204,194279,else,1,75,trnSL-Val1
444,tRNA,194282,194358,else,1,76,trnSL-Thr1
443,gene,194282,194358,gene,1,76,trnSL-Val1
445,gene,194362,194435,gene,1,73,trnSL-Thr1
446,tRNA,194362,194435,else,1,73,trnSL-Tyr1
447,gene,194457,194542,gene,1,85,trnSL-Tyr1
448,tRNA,194457,194542,else,1,85,trnSL-Gln2
449,gene,194546,194621,gene,1,75,trnSL-Gln2
450,tRNA,194546,194621,else,1,75,sigW
452,CDS,194848,195412,CDS,1,564,rsiW
451,gene,194848,195412,gene,1,564,sigW
453,gene,195425,196052,gene,1,627,rsiW
454,CDS,195425,196052,CDS,1,627,cdaA
455,gene,196212,197034,gene,1,822,cdaA
456,CDS,196212,197034,CDS,1,822,cdaR
457,gene,197026,198478,gene,1,1452,cdaR
458,CDS,197026,198478,CDS,1,1452,glmM
460,CDS,198496,199843,CDS,1,1347,glmSA
459,gene,198496,199843,gene,1,1347,glmM
462,misc_RNA,200016,200187,else,1,171,glmS
461,gene,200016,200187,gene,1,171,glmSA
463,gene,200276,202079,gene,1,1803,glmS
464,CDS,200276,202079,CDS,1,1803,ybbU
465,gene,202125,202266,gene,1,141,ybbU
466,CDS,202125,202266,CDS,1,141,alkA
467,gene,202546,203458,gene,-1,912,alkA
468,CDS,202546,203458,CDS,-1,912,adaA
469,gene,203728,204364,gene,1,636,adaA
470,CDS,203728,204364,CDS,1,636,adaB
472,CDS,204350,204890,CDS,1,540,ndhF
471,gene,204350,204890,gene,1,540,adaB
473,gene,205408,206926,gene,1,1518,ndhF
474,CDS,205408,206926,CDS,1,1518,ybcC
475,gene,206940,209556,gene,1,2616,ybcC
476,CDS,206940,209556,CDS,1,2616,ybcF
477,gene,209632,210160,gene,1,528,ybcF
478,CDS,209632,210160,CDS,1,528,ybcH
480,CDS,210223,210514,CDS,1,291,ybcI
479,gene,210223,210514,gene,1,291,ybcH
481,gene,210571,210946,gene,1,375,ybcI
482,CDS,210571,210946,CDS,1,375,ybzH
483,gene,211428,211731,gene,1,303,ybzH
484,CDS,211428,211731,CDS,1,303,ybcL
485,gene,211858,213031,gene,1,1173,ybcL
486,CDS,211858,213031,CDS,1,1173,ybcM
487,gene,213154,213469,gene,1,315,ybcM
488,CDS,213154,213469,CDS,1,315,skfA
489,gene,213940,214108,gene,1,168,skfA
490,CDS,213940,214108,CDS,1,168,skfB
491,gene,214174,215407,gene,1,1233,skfB
492,CDS,214174,215407,CDS,1,1233,skfC
493,gene,215403,216894,gene,1,1491,skfC
494,CDS,215403,216894,CDS,1,1491,skfE
496,CDS,216912,217632,CDS,1,720,skfF
495,gene,216912,217632,gene,1,720,skfE
497,gene,217696,219040,gene,1,1344,skfF
498,CDS,217696,219040,CDS,1,1344,skfG
499,gene,219086,219602,gene,1,516,skfG
500,CDS,219086,219602,CDS,1,516,skfH
501,gene,219606,220032,gene,1,426,skfH
502,CDS,219606,220032,CDS,1,426,ybdG
503,gene,220278,221256,gene,1,978,ybdG
504,CDS,220278,221256,CDS,1,978,ybdJ
505,gene,221257,221929,gene,1,672,ybdJ
506,CDS,221257,221929,CDS,1,672,ybdK
507,gene,221949,222912,gene,1,963,ybdK
508,CDS,221949,222912,CDS,1,963,ybzI
509,gene,222970,223234,gene,1,264,ybzI
510,CDS,222970,223234,CDS,1,264,ybdM
512,CDS,223218,223989,CDS,-1,771,ybdN
511,gene,223218,223989,gene,-1,771,ybdM
513,gene,224074,224932,gene,-1,858,ybdN
514,CDS,224074,224932,CDS,-1,858,ybdO
515,gene,225063,226248,gene,1,1185,ybdO
516,CDS,225063,226248,CDS,1,1185,ybxG
517,gene,226565,227954,gene,1,1389,ybxG
518,CDS,226565,227954,CDS,1,1389,csgA
520,CDS,228065,228314,CDS,1,249,ybxH
519,gene,228065,228314,gene,1,249,csgA
521,gene,228330,228522,gene,1,192,ybxH
522,CDS,228330,228522,CDS,1,192,ybxI
523,gene,228548,229352,gene,-1,804,ybxI
524,CDS,228548,229352,CDS,-1,804,cypC
525,gene,229524,230778,gene,1,1254,cypC
526,CDS,229524,230778,CDS,1,1254,ybyB
527,gene,230818,231079,gene,-1,261,ybyB
528,CDS,230818,231079,CDS,-1,261,ybeC
530,CDS,231347,232967,CDS,1,1620,glpQA
529,gene,231347,232967,gene,1,1620,ybeC
531,gene,233013,233895,gene,-1,882,glpQA
532,CDS,233013,233895,CDS,-1,882,glpT
533,gene,233993,235328,gene,-1,1335,glpT
534,CDS,233993,235328,CDS,-1,1335,ybeF
535,gene,235624,235873,gene,1,249,ybeF
536,CDS,235624,235873,CDS,1,249,ybfA
538,CDS,235964,236882,CDS,1,918,ybfB
537,gene,235964,236882,gene,1,918,ybfA
539,gene,236878,238129,gene,1,1251,ybfB
540,CDS,236878,238129,CDS,1,1251,ybfEc
541,gene,238163,238448,gene,-1,285,ybfEc
542,misc_feature,238163,238448,else,-1,285,ybfEn
543,gene,238353,238476,gene,-1,123,ybfEn
544,misc_feature,238353,238476,else,-1,123,ybfF
545,gene,238643,239555,gene,-1,912,ybfF
546,CDS,238643,239555,CDS,-1,912,ybfG
548,CDS,239643,241842,CDS,-1,2199,ybfH
547,gene,239643,241842,gene,-1,2199,ybfG
549,gene,241916,242837,gene,-1,921,ybfH
550,CDS,241916,242837,CDS,-1,921,ybfI
551,gene,242833,243661,gene,-1,828,ybfI
552,CDS,242833,243661,CDS,-1,828,purT
553,gene,243891,245046,gene,1,1155,purT
554,CDS,243891,245046,CDS,1,1155,mpr
555,gene,245189,246131,gene,1,942,mpr
556,CDS,245189,246131,CDS,1,942,ybfJ
557,gene,246093,246492,gene,1,399,ybfJ
558,CDS,246093,246492,CDS,1,399,cesB
559,gene,246657,247548,gene,1,891,cesB
560,CDS,246657,247548,CDS,1,891,pssA
561,gene,247743,248277,gene,1,534,pssA
562,CDS,247743,248277,CDS,1,534,ybfM
563,gene,248267,248756,gene,1,489,ybfM
564,CDS,248267,248756,CDS,1,489,psd
566,CDS,248748,249540,CDS,1,792,ybfN
565,gene,248748,249540,gene,1,792,psd
568,CDS,249594,249873,CDS,1,279,ybfO
567,gene,249594,249873,gene,1,279,ybfN
569,gene,249978,251319,gene,1,1341,ybfO
570,CDS,249978,251319,CDS,1,1341,ybfP
571,gene,251426,252314,gene,1,888,ybfP
572,CDS,251426,252314,CDS,1,888,ybfQ
573,gene,252513,253482,gene,1,969,ybfQ
574,CDS,252513,253482,CDS,1,969,gltP
575,gene,253517,254762,gene,-1,1245,gltP
576,CDS,253517,254762,CDS,-1,1245,gamP
577,gene,254906,256802,gene,-1,1896,gamP
578,CDS,254906,256802,CDS,-1,1896,gamA
579,gene,256822,257572,gene,-1,750,gamA
580,CDS,256822,257572,CDS,-1,750,gamR
581,gene,257790,258498,gene,1,708,gamR
582,CDS,257790,258498,CDS,1,708,ybgB
584,CDS,258531,258807,CDS,1,276,ilvE
583,gene,258531,258807,gene,1,276,ybgB
585,gene,259015,260086,gene,1,1071,ilvE
586,CDS,259015,260086,CDS,1,1071,ybgF
587,gene,260122,261535,gene,-1,1413,ybgF
588,CDS,260122,261535,CDS,-1,1413,ybgG
589,gene,261655,262603,gene,-1,948,ybgG
590,CDS,261655,262603,CDS,-1,948,glnT
592,CDS,262731,264168,CDS,-1,1437,glsA
591,gene,262731,264168,gene,-1,1437,glnT
593,gene,264190,265174,gene,-1,984,glsA
594,CDS,264190,265174,CDS,-1,984,glnJ
595,gene,265475,266708,gene,1,1233,glnJ
596,CDS,265475,266708,CDS,1,1233,glnL
597,gene,266718,267663,gene,1,945,glnL
598,CDS,266718,267663,CDS,1,945,kdgD
599,gene,267889,268816,gene,1,927,kdgD
600,CDS,267889,268816,CDS,1,927,gucD
602,CDS,268845,270312,CDS,1,1467,gudP
601,gene,268845,270312,gene,1,1467,gucD
603,gene,270395,271763,gene,1,1368,gudP
604,CDS,270395,271763,CDS,1,1368,gudD
605,gene,271799,273167,gene,1,1368,gudD
606,CDS,271799,273167,CDS,1,1368,garR
607,gene,273236,273938,gene,1,702,garR
608,CDS,273236,273938,CDS,1,702,garD
610,CDS,274028,275561,CDS,1,1533,ycbJ
609,gene,274028,275561,gene,1,1533,garD
611,gene,275837,276758,gene,1,921,ycbJ
612,CDS,275837,276758,CDS,1,921,tboW
613,gene,276814,277062,gene,1,248,tboW
614,misc_RNA,276814,277062,else,1,248,rtpA
615,gene,277159,277321,gene,1,162,rtpA
616,CDS,277159,277321,CDS,1,162,ycbK
617,gene,277341,278280,gene,1,939,ycbK
618,CDS,277341,278280,CDS,1,939,ycbL
620,CDS,278376,279057,CDS,1,681,ycbM
619,gene,278376,279057,gene,1,681,ycbL
621,gene,279058,279994,gene,1,936,ycbM
622,CDS,279058,279994,CDS,1,936,ycbN
623,gene,280085,281009,gene,1,924,ycbN
624,CDS,280085,281009,CDS,1,924,ycbO
625,gene,281027,281714,gene,1,687,ycbO
626,CDS,281027,281714,CDS,1,687,BSU_02585
627,gene,281674,281809,gene,-1,135,BSU_02585
628,CDS,281674,281809,CDS,-1,135,ycbP
629,gene,281768,282155,gene,-1,387,ycbP
630,CDS,281768,282155,CDS,-1,387,cwlJ
631,gene,282468,282897,gene,1,429,cwlJ
632,CDS,282468,282897,CDS,1,429,ycbR
633,gene,283002,283734,gene,1,732,ycbR
634,CDS,283002,283734,CDS,1,732,yczK
635,gene,283815,283992,gene,1,177,yczK
636,CDS,283815,283992,CDS,1,177,phoD
638,CDS,284010,285762,CDS,1,1752,tatAD
637,gene,284010,285762,gene,1,1752,phoD
639,gene,285774,285987,gene,1,213,tatAD
640,CDS,285774,285987,CDS,1,213,tatCD
641,gene,286047,286776,gene,1,729,tatCD
642,CDS,286047,286776,CDS,1,729,pcp
643,gene,286772,287420,gene,-1,648,pcp
644,CDS,286772,287420,CDS,-1,648,ycbU
646,CDS,287498,288611,CDS,1,1113,lmrB
645,gene,287498,288611,gene,1,1113,ycbU
647,gene,288652,290092,gene,-1,1440,lmrB
648,CDS,288652,290092,CDS,-1,1440,lmrA
649,gene,290131,290698,gene,-1,567,lmrA
650,CDS,290131,290698,CDS,-1,567,ansZ
651,gene,290914,292042,gene,1,1128,ansZ
652,CDS,290914,292042,CDS,1,1128,estA
654,CDS,292204,292843,CDS,1,639,yczC
653,gene,292204,292843,gene,1,639,estA
656,CDS,292880,293264,CDS,-1,384,yccF
655,gene,292880,293264,gene,-1,384,yczC
657,gene,293498,294575,gene,1,1077,yccF
658,CDS,293498,294575,CDS,1,1077,natK
659,gene,294614,295571,gene,-1,957,natK
660,CDS,294614,295571,CDS,-1,957,natR
661,gene,295583,296285,gene,-1,702,natR
662,CDS,295583,296285,CDS,-1,702,natA
663,gene,296428,297169,gene,1,741,natA
664,CDS,296428,297169,CDS,1,741,natB
666,CDS,297169,298330,CDS,1,1161,yccK
665,gene,297169,298330,gene,1,1161,natB
667,gene,298465,299398,gene,1,933,yccK
668,CDS,298465,299398,CDS,1,933,ycdA
669,gene,299437,300502,gene,-1,1065,ycdA
670,CDS,299437,300502,CDS,-1,1065,BSU_02785
671,gene,300524,300656,gene,-1,132,BSU_02785
672,CDS,300524,300656,CDS,-1,132,ycdB
674,CDS,300829,302248,CDS,1,1419,ycdC
673,gene,300829,302248,gene,1,1419,ycdB
675,gene,302434,303796,gene,1,1362,ycdC
676,CDS,302434,303796,CDS,1,1362,cwlK
677,gene,303803,304307,gene,-1,504,cwlK
678,CDS,303803,304307,CDS,-1,504,rapJ
679,gene,304429,305551,gene,1,1122,rapJ
680,CDS,304429,305551,CDS,1,1122,ycdF
681,gene,305657,306434,gene,1,777,ycdF
682,CDS,305657,306434,CDS,1,777,ycdG
683,gene,306458,308144,gene,1,1686,ycdG
684,CDS,306458,308144,CDS,1,1686,znuA
685,gene,308331,309291,gene,1,960,znuA
686,CDS,308331,309291,CDS,1,960,znuC
687,gene,309346,310042,gene,1,696,znuC
688,CDS,309346,310042,CDS,1,696,znuB
690,CDS,309999,310842,CDS,1,843,yceB
689,gene,309999,310842,gene,1,843,znuB
691,gene,310879,311875,gene,-1,996,yceB
692,CDS,310879,311875,CDS,-1,996,yceC
693,gene,312158,312758,gene,1,600,yceC
694,CDS,312158,312758,CDS,1,600,yceD
695,gene,312779,313361,gene,1,582,yceD
696,CDS,312779,313361,CDS,1,582,yceE
698,CDS,313395,313974,CDS,1,579,yceF
697,gene,313395,313974,gene,1,579,yceE
699,gene,314024,314798,gene,1,774,yceF
700,CDS,314024,314798,CDS,1,774,yceG
701,gene,314882,316496,gene,1,1614,yceG
702,CDS,314882,316496,CDS,1,1614,yceH
703,gene,316511,317603,gene,1,1092,yceH
704,CDS,316511,317603,CDS,1,1092,niaP
705,gene,317724,318927,gene,1,1203,niaP
706,CDS,317724,318927,CDS,1,1203,yceJ
707,gene,319179,320352,gene,-1,1173,yceJ
708,CDS,319179,320352,CDS,-1,1173,yceK
710,CDS,320420,320723,CDS,-1,303,opuAA
709,gene,320420,320723,gene,-1,303,yceK
711,gene,321012,322269,gene,1,1257,opuAA
712,CDS,321012,322269,CDS,1,1257,opuAB
713,gene,322270,323119,gene,1,849,opuAB
714,CDS,322270,323119,CDS,1,849,opuAC
715,gene,323118,324000,gene,1,882,opuAC
716,CDS,323118,324000,CDS,1,882,amhX
717,gene,324037,325189,gene,-1,1152,amhX
718,CDS,324037,325189,CDS,-1,1152,ycgA
719,gene,325338,326772,gene,1,1434,ycgA
720,CDS,325338,326772,CDS,1,1434,ycgB
721,gene,326887,327469,gene,1,582,ycgB
722,CDS,326887,327469,CDS,1,582,amyE
723,gene,327617,329597,gene,1,1980,amyE
724,CDS,327617,329597,CDS,1,1980,lctE
726,CDS,329773,330739,CDS,1,966,lctP
725,gene,329773,330739,gene,1,966,lctE
727,gene,330770,332396,gene,1,1626,lctP
728,CDS,330770,332396,CDS,1,1626,mdr
729,gene,332440,333979,gene,-1,1539,mdr
730,CDS,332440,333979,CDS,-1,1539,ycgE
731,gene,334091,334556,gene,1,465,ycgE
732,CDS,334091,334556,CDS,1,465,ycgF
734,CDS,334629,335259,CDS,1,630,ycgG
733,gene,334629,335259,gene,1,630,ycgF
735,gene,335328,336090,gene,1,762,ycgG
736,CDS,335328,336090,CDS,1,762,ycgH
737,gene,336091,337432,gene,-1,1341,ycgH
738,CDS,336091,337432,CDS,-1,1341,ycgI
739,gene,337561,338158,gene,1,597,ycgI
740,CDS,337561,338158,CDS,1,597,nadE
741,gene,338287,339106,gene,1,819,nadE
742,CDS,338287,339106,CDS,1,819,tmrB
744,CDS,339155,339749,CDS,-1,594,aroK
743,gene,339155,339749,gene,-1,594,tmrB
745,gene,340024,340585,gene,1,561,aroK
746,CDS,340024,340585,CDS,1,561,ycgJ
747,gene,340612,341374,gene,-1,762,ycgJ
748,CDS,340612,341374,CDS,-1,762,ycgK
749,gene,341491,342466,gene,1,975,ycgK
750,CDS,341491,342466,CDS,1,975,cah
752,CDS,342537,343494,CDS,1,957,ycgL
751,gene,342537,343494,gene,1,957,cah
753,gene,343577,344360,gene,1,783,ycgL
754,CDS,343577,344360,CDS,1,783,putB
755,gene,344550,345462,gene,1,912,putB
756,CDS,344550,345462,CDS,1,912,putC
757,gene,345478,347026,gene,1,1548,putC
758,CDS,345478,347026,CDS,1,1548,putP
759,gene,347149,348571,gene,1,1422,putP
760,CDS,347149,348571,CDS,1,1422,putR
762,CDS,348723,349959,CDS,1,1236,ycgQ
761,gene,348723,349959,gene,1,1236,putR
763,gene,349995,350853,gene,-1,858,ycgQ
764,CDS,349995,350853,CDS,-1,858,ycgR
765,gene,350857,351742,gene,-1,885,ycgR
766,CDS,350857,351742,CDS,-1,885,ycgS
767,gene,351841,352696,gene,-1,855,ycgS
768,CDS,351841,352696,CDS,-1,855,ffoR
769,gene,352857,353868,gene,1,1011,ffoR
770,CDS,352857,353868,CDS,1,1011,nasF
771,gene,353899,355351,gene,-1,1452,nasF
772,CDS,353899,355351,CDS,-1,1452,nasE
773,gene,355411,355732,gene,-1,321,nasE
774,CDS,355411,355732,CDS,-1,321,nasD
775,gene,355763,358181,gene,-1,2418,nasD
776,CDS,355763,358181,CDS,-1,2418,nasC
778,CDS,358302,360435,CDS,-1,2133,nasB
777,gene,358302,360435,gene,-1,2133,nasC
780,CDS,360441,362757,CDS,-1,2316,nasA
779,gene,360441,362757,gene,-1,2316,nasB
781,gene,362936,364142,gene,1,1206,nasA
782,CDS,362936,364142,CDS,1,1206,folEB
783,gene,364258,365173,gene,1,915,folEB
784,CDS,364258,365173,CDS,1,915,yciB
785,gene,365169,365754,gene,1,585,yciB
786,CDS,365169,365754,CDS,1,585,yczL
787,gene,365849,366035,gene,1,186,yczL
788,CDS,365849,366035,CDS,1,186,zinU
789,gene,366062,367256,gene,1,1194,zinU
790,CDS,366062,367256,CDS,1,1194,yckA
791,gene,367304,367985,gene,-1,681,yckA
792,CDS,367304,367985,CDS,-1,681,yckB
793,gene,367994,368858,gene,-1,864,yckB
794,CDS,367994,368858,CDS,-1,864,BSU_03385
796,CDS,369019,369217,CDS,1,198,yckC
795,gene,369019,369217,gene,1,198,BSU_03385
797,gene,369235,369691,gene,1,456,yckC
798,CDS,369235,369691,CDS,1,456,yckD
799,gene,369772,370105,gene,1,333,yckD
800,CDS,369772,370105,CDS,1,333,bglC
801,gene,370258,371692,gene,1,1434,bglC
802,CDS,370258,371692,CDS,1,1434,nin
804,CDS,371728,372127,CDS,-1,399,nucA
803,gene,371728,372127,gene,-1,399,nin
805,gene,372153,372603,gene,-1,450,nucA
806,CDS,372153,372603,CDS,-1,450,tlpC
807,gene,372770,374492,gene,-1,1722,tlpC
808,CDS,372770,374492,CDS,-1,1722,hxlB
809,gene,374602,375160,gene,-1,558,hxlB
810,CDS,374602,375160,CDS,-1,558,hxlA
811,gene,375165,375798,gene,-1,633,hxlA
812,CDS,375165,375798,CDS,-1,633,hxlR
814,CDS,376031,376394,CDS,1,363,srfAA
813,gene,376031,376394,gene,1,363,hxlR
815,gene,376967,387731,gene,1,10764,srfAA
816,CDS,376967,387731,CDS,1,10764,srfAB
817,gene,387743,398495,gene,1,10752,srfAB
818,CDS,387743,398495,CDS,1,10752,comS
819,gene,390879,391020,gene,1,141,comS
820,CDS,390879,391020,CDS,1,141,srfAC
822,CDS,398531,402359,CDS,1,3828,srfAD
821,gene,398531,402359,gene,1,3828,srfAC
823,gene,402387,403116,gene,1,729,srfAD
824,CDS,402387,403116,CDS,1,729,srfT
825,gene,403216,404443,gene,1,1227,srfT
826,CDS,403216,404443,CDS,1,1227,ycxB
827,gene,404457,405015,gene,-1,558,ycxB
828,CDS,404457,405015,CDS,-1,558,ycxC
829,gene,405068,406007,gene,-1,939,ycxC
830,CDS,405068,406007,CDS,-1,939,ycxD
832,CDS,406130,407465,CDS,1,1335,sfpAc
831,gene,406130,407465,gene,1,1335,ycxD
833,gene,407459,407627,gene,-1,168,sfpAc
834,misc_feature,407459,407627,else,-1,168,sfpAn
835,gene,407637,408135,gene,-1,498,sfpAn
836,misc_feature,407637,408135,else,-1,498,yczE
837,gene,408239,408887,gene,-1,648,yczE
838,CDS,408239,408887,CDS,-1,648,tcyC
839,gene,409207,409951,gene,-1,744,tcyC
840,CDS,409207,409951,CDS,-1,744,tcyB
841,gene,409964,410669,gene,-1,705,tcyB
842,CDS,409964,410669,CDS,-1,705,tcyA
843,gene,410655,411462,gene,-1,807,tcyA
844,CDS,410655,411462,CDS,-1,807,bsdA
845,gene,411577,412450,gene,-1,873,bsdA
846,CDS,411577,412450,CDS,-1,873,ubiX
847,gene,412539,413154,gene,1,615,ubiX
848,CDS,412539,413154,CDS,1,615,bsdC
850,CDS,413156,414578,CDS,1,1422,bsdD
849,gene,413156,414578,gene,1,1422,bsdC
852,CDS,414594,414822,CDS,1,228,yclD
851,gene,414594,414822,gene,1,228,bsdD
853,gene,414818,415283,gene,1,465,yclD
854,CDS,414818,415283,CDS,1,465,yclE
855,gene,415349,416195,gene,1,846,yclE
856,CDS,415349,416195,CDS,1,846,dtpT
857,gene,416234,417713,gene,-1,1479,dtpT
858,CDS,416234,417713,CDS,-1,1479,yclG
859,gene,417992,419747,gene,1,1755,yclG
860,CDS,417992,419747,CDS,1,1755,yczF
862,CDS,419762,419984,CDS,-1,222,gerKA
861,gene,419762,419984,gene,-1,222,yczF
863,gene,420109,421744,gene,1,1635,gerKA
864,CDS,420109,421744,CDS,1,1635,gerKC
865,gene,421733,422957,gene,1,1224,gerKC
866,CDS,421733,422957,CDS,1,1224,gerKB
867,gene,422981,424103,gene,1,1122,gerKB
868,CDS,422981,424103,CDS,1,1122,yclH
870,CDS,424207,424888,CDS,-1,681,yclI
869,gene,424207,424888,gene,-1,681,yclH
871,gene,424903,426364,gene,-1,1461,yclI
872,CDS,424903,426364,CDS,-1,1461,yclJ
873,gene,426576,427260,gene,1,684,yclJ
874,CDS,426576,427260,CDS,1,684,yclK
875,gene,427246,428668,gene,1,1422,yclK
876,CDS,427246,428668,CDS,1,1422,rapC
877,gene,428830,429979,gene,1,1149,rapC
878,CDS,428830,429979,CDS,1,1149,phrC
879,gene,429962,430085,gene,1,123,phrC
880,CDS,429962,430085,CDS,1,123,yczM
881,gene,430184,430274,gene,-1,90,yczM
882,CDS,430184,430274,CDS,-1,90,yczN
883,gene,430355,430469,gene,-1,114,yczN
884,CDS,430355,430469,CDS,-1,114,thrD
885,gene,430622,431987,gene,-1,1365,thrD
886,CDS,430622,431987,CDS,-1,1365,pbtN
888,CDS,432371,433322,CDS,1,951,pbtO
887,gene,432371,433322,gene,1,951,pbtN
889,gene,433314,434262,gene,1,948,pbtO
890,CDS,433314,434262,CDS,1,948,pbtP
891,gene,434255,435014,gene,1,759,pbtP
892,CDS,434255,435014,CDS,1,759,pbtQ
893,gene,435035,435989,gene,1,954,pbtQ
894,CDS,435035,435989,CDS,1,954,ycnB
896,CDS,436035,437454,CDS,-1,1419,ycnC
895,gene,436035,437454,gene,-1,1419,ycnB
897,gene,437473,438352,gene,-1,879,ycnC
898,CDS,437473,438352,CDS,-1,879,nfrAB
899,gene,438515,439265,gene,-1,750,nfrAB
900,CDS,438515,439265,CDS,-1,750,ycnE
901,gene,439281,439569,gene,-1,288,ycnE
902,CDS,439281,439569,CDS,-1,288,yczG
903,gene,439708,440023,gene,1,315,yczG
904,CDS,439708,440023,CDS,1,315,gabR
906,CDS,440024,441464,CDS,-1,1440,gabT
905,gene,440024,441464,gene,-1,1440,gabR
907,gene,441570,442881,gene,1,1311,gabT
908,CDS,441570,442881,CDS,1,1311,gabD
909,gene,442949,444338,gene,1,1389,gabD
910,CDS,442949,444338,CDS,1,1389,glcU
911,gene,444460,445324,gene,1,864,glcU
912,CDS,444460,445324,CDS,1,864,gdh
913,gene,445343,446129,gene,1,786,gdh
914,CDS,445343,446129,CDS,1,786,cutI
915,gene,446173,446788,gene,-1,615,cutI
916,CDS,446173,446788,CDS,-1,615,cutJ
917,gene,446800,448426,gene,-1,1626,cutJ
918,CDS,446800,448426,CDS,-1,1626,cutR
919,gene,448460,449033,gene,-1,573,cutR
920,CDS,448460,449033,CDS,-1,573,ycnL
922,CDS,449197,449551,CDS,1,354,mtlA
921,gene,449197,449551,gene,1,354,ycnL
924,CDS,449723,451160,CDS,1,1437,mtlF
923,gene,449723,451160,gene,1,1437,mtlA
925,gene,451184,451616,gene,1,432,mtlF
926,CDS,451184,451616,CDS,1,432,mtlD
927,gene,451617,452739,gene,1,1122,mtlD
928,CDS,451617,452739,CDS,1,1122,ycsA
929,gene,452829,453894,gene,1,1065,ycsA
930,CDS,452829,453894,CDS,1,1065,sipU
931,gene,454028,454592,gene,1,564,sipU
932,CDS,454028,454592,CDS,1,564,yczH
933,gene,454651,455260,gene,-1,609,yczH
934,CDS,454651,455260,CDS,-1,609,ycsD
935,gene,455345,455738,gene,1,393,ycsD
936,CDS,455345,455738,CDS,1,393,yczO
937,gene,455770,455935,gene,-1,165,yczO
938,CDS,455770,455935,CDS,-1,165,ribZ
939,gene,456067,456817,gene,1,750,ribZ
940,CDS,456067,456817,CDS,1,750,pxpA
942,CDS,457022,457796,CDS,1,774,pxpG
941,gene,457022,457796,gene,1,774,pxpA
943,gene,457810,459025,gene,1,1215,pxpG
944,CDS,457810,459025,CDS,1,1215,pxpI
945,gene,459048,459822,gene,1,774,pxpI
946,CDS,459048,459822,CDS,1,774,pxpB
947,gene,459866,460589,gene,1,723,pxpB
948,CDS,459866,460589,CDS,1,723,pxpC
950,CDS,460591,461599,CDS,1,1008,pxpR
949,gene,460591,461599,gene,1,1008,pxpC
951,gene,461614,462367,gene,1,753,pxpR
952,CDS,461614,462367,CDS,1,753,lipC
953,gene,462430,463072,gene,1,642,lipC
954,CDS,462430,463072,CDS,1,642,yczI
955,gene,463244,463490,gene,1,246,yczI
956,CDS,463244,463490,CDS,1,246,yczJ
958,CDS,463495,463783,CDS,-1,288,pbpC
957,gene,463495,463783,gene,-1,288,yczJ
960,CDS,463933,465940,CDS,1,2007,ycsN
959,gene,463933,465940,gene,1,2007,pbpC
961,gene,466041,466944,gene,1,903,ycsN
962,CDS,466041,466944,CDS,1,903,mtlR
963,gene,467129,469214,gene,1,2085,mtlR
964,CDS,467129,469214,CDS,1,2085,ydaB
965,gene,469425,470937,gene,1,1512,ydaB
966,CDS,469425,470937,CDS,1,1512,ydaC
967,gene,470956,471502,gene,-1,546,ydaC
968,CDS,470956,471502,CDS,-1,546,ydaD
970,CDS,471708,472569,CDS,1,861,lyxE
969,gene,471708,472569,gene,1,861,ydaD
971,gene,472584,473088,gene,1,504,lyxE
972,CDS,472584,473088,CDS,1,504,ydaF
973,gene,473173,473725,gene,1,552,ydaF
974,CDS,473173,473725,CDS,1,552,ydaG
975,gene,473802,474225,gene,1,423,ydaG
976,CDS,473802,474225,CDS,1,423,bsrC
978,misc_RNA,474328,474597,else,-1,269,amj
977,gene,474328,474597,gene,-1,269,bsrC
979,gene,474730,475540,gene,1,810,amj
980,CDS,474730,475540,CDS,1,810,ydzA
981,gene,475583,475874,gene,-1,291,ydzA
982,CDS,475583,475874,CDS,-1,291,lrpC
983,gene,476058,476493,gene,1,435,lrpC
984,CDS,476058,476493,CDS,1,435,topB
985,gene,476557,478741,gene,1,2184,topB
986,CDS,476557,478741,CDS,1,2184,epsJ
987,gene,478943,480032,gene,1,1089,epsJ
988,CDS,478943,480032,CDS,1,1089,epsK
989,gene,480012,480864,gene,1,852,epsK
990,CDS,480012,480864,CDS,1,852,ydaL
991,gene,480874,482584,gene,1,1710,ydaL
992,CDS,480874,482584,CDS,1,1710,ydaM
994,CDS,482576,483839,CDS,1,1263,ydaN
993,gene,482576,483839,gene,1,1263,ydaM
995,gene,483844,485956,gene,1,2112,ydaN
996,CDS,483844,485956,CDS,1,2112,swaO
997,gene,486091,486235,gene,1,144,swaO
998,misc_RNA,486091,486235,else,1,144,kimA
999,gene,486431,488255,gene,1,1824,kimA
1000,CDS,486431,488255,CDS,1,1824,nudT
1001,gene,488313,488763,gene,1,450,nudT
1002,CDS,488313,488763,CDS,1,450,poxB
1003,gene,488829,490554,gene,1,1725,poxB
1004,CDS,488829,490554,CDS,1,1725,BSU_04345
1005,gene,490545,490749,gene,-1,204,BSU_04345
1006,CDS,490545,490749,CDS,-1,204,ydzK
1007,gene,490776,491043,gene,-1,267,ydzK
1008,CDS,490776,491043,CDS,-1,267,mntH
1010,CDS,491146,492424,CDS,-1,1278,ydaS
1009,gene,491146,492424,gene,-1,1278,mntH
1011,gene,492653,492911,gene,-1,258,ydaS
1012,CDS,492653,492911,CDS,-1,258,ydaT
1013,gene,492988,493441,gene,-1,453,ydaT
1014,CDS,492988,493441,CDS,-1,453,ydbA
1015,gene,493558,494377,gene,1,819,ydbA
1016,CDS,493558,494377,CDS,1,819,gsiB
1018,CDS,494505,494877,CDS,1,372,ydbB
1017,gene,494505,494877,gene,1,372,gsiB
1019,gene,495008,495350,gene,1,342,ydbB
1020,CDS,495008,495350,CDS,1,342,ydbC
1021,gene,495343,495703,gene,1,360,ydbC
1022,CDS,495343,495703,CDS,1,360,ydbD
1023,gene,495739,496561,gene,-1,822,ydbD
1024,CDS,495739,496561,CDS,-1,822,dctB
1025,gene,496645,497698,gene,-1,1053,dctB
1026,CDS,496645,497698,CDS,-1,1053,dctS
1028,CDS,497767,499375,CDS,1,1608,dctR
1027,gene,497767,499375,gene,1,1608,dctS
1029,gene,499364,500045,gene,1,681,dctR
1030,CDS,499364,500045,CDS,1,681,dctP
1031,gene,500165,501431,gene,1,1266,dctP
1032,CDS,500165,501431,CDS,1,1266,ydbI
1033,gene,501578,502631,gene,1,1053,ydbI
1034,CDS,501578,502631,CDS,1,1053,ydbJ
1036,CDS,502907,503834,CDS,1,927,ydbK
1035,gene,502907,503834,gene,1,927,ydbJ
1037,gene,503853,504594,gene,1,741,ydbK
1038,CDS,503853,504594,CDS,1,741,ydbL
1039,gene,504688,505024,gene,1,336,ydbL
1040,CDS,504688,505024,CDS,1,336,ydbM
1041,gene,505151,506297,gene,1,1146,ydbM
1042,CDS,505151,506297,CDS,1,1146,fbpB
1043,gene,506321,506501,gene,-1,180,fbpB
1044,CDS,506321,506501,CDS,-1,180,fbpA
1046,CDS,506454,506619,CDS,-1,165,ydbO
1045,gene,506454,506619,gene,-1,165,fbpA
1047,gene,506865,507738,gene,1,873,ydbO
1048,CDS,506865,507738,CDS,1,873,ydbP
1049,gene,507752,508073,gene,-1,321,ydbP
1050,CDS,507752,508073,CDS,-1,321,ddlA
1051,gene,508247,509312,gene,1,1065,ddlA
1052,CDS,508247,509312,CDS,1,1065,murF
1053,gene,509383,510757,gene,1,1374,murF
1054,CDS,509383,510757,CDS,1,1374,cshA
1055,gene,511156,512641,gene,1,1485,cshA
1056,CDS,511156,512641,CDS,1,1485,ydbS
1057,gene,512813,513293,gene,1,480,ydbS
1058,CDS,512813,513293,CDS,1,480,ydbT
1059,gene,513282,514764,gene,1,1482,ydbT
1060,CDS,513282,514764,CDS,1,1482,ydcA
1061,gene,515015,515615,gene,-1,600,ydcA
1062,CDS,515015,515615,CDS,-1,600,acpS
1064,CDS,515709,516075,CDS,1,366,ydcC
1063,gene,515709,516075,gene,1,366,acpS
1065,gene,516240,517257,gene,1,1017,ydcC
1066,CDS,516240,517257,CDS,1,1017,alrA
1067,gene,517371,518541,gene,1,1170,alrA
1068,CDS,517371,518541,CDS,1,1170,ndoAI
1069,gene,518656,518938,gene,1,282,ndoAI
1070,CDS,518656,518938,CDS,1,282,ndoA
1071,gene,518942,519293,gene,1,351,ndoA
1072,CDS,518942,519293,CDS,1,351,rsbRA
1073,gene,519407,520232,gene,1,825,rsbRA
1074,CDS,519407,520232,CDS,1,825,rsbS
1075,gene,520236,520602,gene,1,366,rsbS
1076,CDS,520236,520602,CDS,1,366,rsbT
1077,gene,520605,521007,gene,1,402,rsbT
1078,CDS,520605,521007,CDS,1,402,rsbU
1080,CDS,521018,522026,CDS,1,1008,rsbV
1079,gene,521018,522026,gene,1,1008,rsbU
1081,gene,522087,522417,gene,1,330,rsbV
1082,CDS,522087,522417,CDS,1,330,rsbW
1083,gene,522413,522896,gene,1,483,rsbW
1084,CDS,522413,522896,CDS,1,483,sigB
1085,gene,522861,523650,gene,1,789,sigB
1086,CDS,522861,523650,CDS,1,789,rsbX
1088,CDS,523649,524249,CDS,1,600,BSU_04745
1087,gene,523649,524249,gene,1,600,rsbX
1089,gene,524359,524476,gene,1,117,BSU_04745
1090,CDS,524359,524476,CDS,1,117,ydcF
1091,gene,524491,524785,gene,1,294,ydcF
1092,CDS,524491,524785,CDS,1,294,ydcG
1093,gene,524781,525222,gene,1,441,ydcG
1094,CDS,524781,525222,CDS,1,441,ydcH
1096,CDS,525205,525649,CDS,1,444,tex
1095,gene,525205,525649,gene,1,444,ydcH
1098,CDS,525742,527902,CDS,1,2160,cmpA
1097,gene,525742,527902,gene,1,2160,tex
1099,gene,527911,528025,gene,-1,114,cmpA
1100,CDS,527911,528025,CDS,-1,114,ydcK
1101,gene,528128,528581,gene,1,453,ydcK
1102,CDS,528128,528581,CDS,1,453,trnS-Asn
1103,gene,528703,528778,gene,1,75,trnS-Asn
1104,tRNA,528703,528778,else,1,75,trnS-Ser
1105,gene,528782,528873,gene,1,91,trnS-Ser
1106,tRNA,528782,528873,else,1,91,trnS-Glu
1107,gene,528902,528974,gene,1,72,trnS-Glu
1108,tRNA,528902,528974,else,1,72,trnS-Gln
1109,gene,528985,529060,gene,1,75,trnS-Gln
1110,tRNA,528985,529060,else,1,75,trnS-Lys
1111,gene,529086,529162,gene,1,76,trnS-Lys
1112,tRNA,529086,529162,else,1,76,trnS-Leu1
1114,tRNA,529173,529255,else,1,82,trnS-Leu2
1113,gene,529173,529255,gene,1,82,trnS-Leu1
1115,gene,529335,529422,gene,1,87,trnS-Leu2
1116,tRNA,529335,529422,else,1,87,ydcL
1117,gene,529504,530611,gene,-1,1107,ydcL
1118,CDS,529504,530611,CDS,-1,1107,immA
1119,gene,530623,531133,gene,-1,510,immA
1120,CDS,530623,531133,CDS,-1,510,immR
1122,CDS,531129,531513,CDS,-1,384,xis
1121,gene,531129,531513,gene,-1,384,immR
1123,gene,531786,531981,gene,1,195,xis
1124,CDS,531786,531981,CDS,1,195,ydzL
1125,gene,531977,532238,gene,1,261,ydzL
1126,CDS,531977,532238,CDS,1,261,ydcO
1127,gene,532291,532552,gene,1,261,ydcO
1128,CDS,532291,532552,CDS,1,261,sncO
1129,gene,532582,532642,gene,-1,60,sncO
1130,misc_RNA,532582,532642,else,-1,60,BSU_04849
1132,CDS,532757,532886,CDS,1,129,helP
1131,gene,532757,532886,gene,1,129,BSU_04849
1134,CDS,532921,533302,CDS,1,381,conQ
1133,gene,532921,533302,gene,1,381,helP
1135,gene,533337,534780,gene,1,1443,conQ
1136,CDS,533337,534780,CDS,1,1443,nicK
1137,gene,534772,535831,gene,1,1059,nicK
1138,CDS,534772,535831,CDS,1,1059,ydcS
1139,gene,536095,536365,gene,1,270,ydcS
1140,CDS,536095,536365,CDS,1,270,ydcT
1141,gene,536403,536670,gene,1,267,ydcT
1142,CDS,536403,536670,CDS,1,267,yddA
1143,gene,536686,536995,gene,1,309,yddA
1144,CDS,536686,536995,CDS,1,309,conB
1145,gene,536984,538049,gene,1,1065,conB
1146,CDS,536984,538049,CDS,1,1065,conC
1147,gene,538060,538309,gene,1,249,conC
1148,CDS,538060,538309,CDS,1,249,conD
1149,gene,538321,538846,gene,1,525,conD
1150,CDS,538321,538846,CDS,1,525,conE
1152,CDS,538733,541229,CDS,1,2496,yddF
1151,gene,538733,541229,gene,1,2496,conE
1153,gene,541247,541574,gene,1,327,yddF
1154,CDS,541247,541574,CDS,1,327,conG
1155,gene,541577,544025,gene,1,2448,conG
1156,CDS,541577,544025,CDS,1,2448,cwlT
1157,gene,544021,545011,gene,1,990,cwlT
1158,CDS,544021,545011,CDS,1,990,yddI
1160,CDS,545025,545532,CDS,1,507,yddJ
1159,gene,545025,545532,gene,1,507,yddI
1161,gene,545594,545975,gene,1,381,yddJ
1162,CDS,545594,545975,CDS,1,381,yddK
1163,gene,546165,546966,gene,-1,801,yddK
1164,CDS,546165,546966,CDS,-1,801,rapI
1165,gene,547305,548481,gene,1,1176,rapI
1166,CDS,547305,548481,CDS,1,1176,phrI
1168,CDS,548437,548557,CDS,1,120,yddM
1167,gene,548437,548557,gene,1,120,phrI
1170,CDS,548709,549651,CDS,1,942,yddN
1169,gene,548709,549651,gene,1,942,yddM
1171,gene,550239,551259,gene,-1,1020,yddN
1172,CDS,550239,551259,CDS,-1,1020,lrpA
1173,gene,551518,551929,gene,1,411,lrpA
1174,CDS,551518,551929,CDS,1,411,lrpB
1175,gene,552051,552501,gene,-1,450,lrpB
1176,CDS,552051,552501,CDS,-1,450,yddQ
1177,gene,552615,553158,gene,1,543,yddQ
1178,CDS,552615,553158,CDS,1,543,yddR
1180,CDS,553710,554475,CDS,1,765,yddS
1179,gene,553710,554475,gene,1,765,yddR
1181,gene,554668,555979,gene,1,1311,yddS
1182,CDS,554668,555979,CDS,1,1311,ydzM
1183,gene,556561,556738,gene,1,177,ydzM
1184,CDS,556561,556738,CDS,1,177,yddT
1185,gene,556762,557449,gene,1,687,yddT
1186,CDS,556762,557449,CDS,1,687,ydzN
1188,CDS,557872,558058,CDS,1,186,sufLC
1187,gene,557872,558058,gene,1,186,ydzN
1189,gene,558407,559001,gene,1,594,sufLC
1190,CDS,558407,559001,CDS,1,594,cspC
1191,gene,559263,559464,gene,1,201,cspC
1192,CDS,559263,559464,CDS,1,201,sncZ
1193,gene,559531,559610,gene,-1,79,sncZ
1194,misc_RNA,559531,559610,else,-1,79,cdnL
1195,gene,560150,560612,gene,-1,462,cdnL
1196,CDS,560150,560612,CDS,-1,462,ydzE
1197,gene,561179,561416,gene,-1,237,ydzE
1198,CDS,561179,561416,CDS,-1,237,ydeC
1199,gene,561513,562389,gene,-1,876,ydeC
1200,CDS,561513,562389,CDS,-1,876,ydeD
1201,gene,562501,563461,gene,1,960,ydeD
1202,CDS,562501,563461,CDS,1,960,ydeE
1204,CDS,563613,564486,CDS,-1,873,ydeF
1203,gene,563613,564486,gene,-1,873,ydeE
1205,gene,564712,566101,gene,1,1389,ydeF
1206,CDS,564712,566101,CDS,1,1389,ydeG
1207,gene,566210,567503,gene,1,1293,ydeG
1208,CDS,566210,567503,CDS,1,1293,ydeH
1209,gene,567661,568108,gene,1,447,ydeH
1210,CDS,567661,568108,CDS,1,447,ydeI
1211,gene,568344,568938,gene,1,594,ydeI
1212,CDS,568344,568938,CDS,1,594,ydeJ
1213,gene,569289,569949,gene,-1,660,ydeJ
1214,CDS,569289,569949,CDS,-1,660,ydeK
1215,gene,570370,571234,gene,-1,864,ydeK
1216,CDS,570370,571234,CDS,-1,864,ydeL
1217,gene,571388,572780,gene,1,1392,ydeL
1218,CDS,571388,572780,CDS,1,1392,ydeM
1220,CDS,572973,573399,CDS,1,426,ydeN
1219,gene,572973,573399,gene,1,426,ydeM
1221,gene,573451,574024,gene,-1,573,ydeN
1222,CDS,573451,574024,CDS,-1,573,ydzF
1223,gene,574105,574435,gene,-1,330,ydzF
1224,CDS,574105,574435,CDS,-1,330,ydeO
1225,gene,574689,575562,gene,1,873,ydeO
1226,CDS,574689,575562,CDS,1,873,ydeP
1228,CDS,575711,576098,CDS,-1,387,ydeQ
1227,gene,575711,576098,gene,-1,387,ydeP
1229,gene,576208,576802,gene,1,594,ydeQ
1230,CDS,576208,576802,CDS,1,594,ydeR
1231,gene,576945,578133,gene,-1,1188,ydeR
1232,CDS,576945,578133,CDS,-1,1188,ydeS
1233,gene,578336,578933,gene,1,597,ydeS
1234,CDS,578336,578933,CDS,1,597,ydzO
1235,gene,579046,579232,gene,1,186,ydzO
1236,CDS,579046,579232,CDS,1,186,aseR
1238,CDS,579540,579876,CDS,1,336,arsF
1237,gene,579540,579876,gene,1,336,aseR
1239,gene,579888,581196,gene,1,1308,arsF
1240,CDS,579888,581196,CDS,1,1308,ydzSn
1241,gene,581227,581329,gene,1,102,ydzSn
1242,misc_feature,581227,581329,else,1,102,ydzSc
1243,gene,581340,581454,gene,1,114,ydzSc
1244,misc_feature,581340,581454,else,1,114,ydfB
1246,CDS,581693,582479,CDS,1,786,ydfC
1245,gene,581693,582479,gene,1,786,ydfB
1247,gene,582535,583456,gene,-1,921,ydfC
1248,CDS,582535,583456,CDS,-1,921,ydfD
1249,gene,583588,585037,gene,1,1449,ydfD
1250,CDS,583588,585037,CDS,1,1449,ydfE
1251,gene,585154,585778,gene,-1,624,ydfE
1252,CDS,585154,585778,CDS,-1,624,ydfF
1253,gene,585867,586548,gene,1,681,ydfF
1254,CDS,585867,586548,CDS,1,681,ydfG
1256,CDS,586627,587071,CDS,-1,444,ydzP
1255,gene,586627,587071,gene,-1,444,ydfG
1257,gene,587156,587336,gene,-1,180,ydzP
1258,CDS,587156,587336,CDS,-1,180,ydzQ
1259,gene,587332,587476,gene,-1,144,ydzQ
1260,CDS,587332,587476,CDS,-1,144,ydfH
1261,gene,587743,588967,gene,1,1224,ydfH
1262,CDS,587743,588967,CDS,1,1224,ydfI
1263,gene,588959,589601,gene,1,642,ydfI
1264,CDS,588959,589601,CDS,1,642,ydfJ
1265,gene,589716,591891,gene,1,2175,ydfJ
1266,CDS,589716,591891,CDS,1,2175,cesA
1267,gene,592302,593205,gene,-1,903,cesA
1268,CDS,592302,593205,CDS,-1,903,ydfK
1269,gene,593406,594096,gene,-1,690,ydfK
1270,CDS,593406,594096,CDS,-1,690,ydfL
1271,gene,594185,594998,gene,-1,813,ydfL
1272,CDS,594185,594998,CDS,-1,813,mneP
1274,CDS,595108,596002,CDS,-1,894,ydfN
1273,gene,595108,596002,gene,-1,894,mneP
1275,gene,596477,597098,gene,1,621,ydfN
1276,CDS,596477,597098,CDS,1,621,ydfO
1277,gene,597113,598052,gene,1,939,ydfO
1278,CDS,597113,598052,CDS,1,939,ydfP
1279,gene,598153,598543,gene,1,390,ydfP
1280,CDS,598153,598543,CDS,1,390,ydfQ
1281,gene,598728,599067,gene,1,339,ydfQ
1282,CDS,598728,599067,CDS,1,339,ydzH
1283,gene,599106,599343,gene,-1,237,ydzH
1284,CDS,599106,599343,CDS,-1,237,ydzR
1285,gene,599874,600105,gene,-1,231,ydzR
1286,CDS,599874,600105,CDS,-1,231,ydfR
1287,gene,600228,600906,gene,-1,678,ydfR
1288,CDS,600228,600906,CDS,-1,678,ydfS
1290,CDS,601018,601726,CDS,1,708,cotP
1289,gene,601018,601726,gene,1,708,ydfS
1291,gene,601740,602172,gene,-1,432,cotP
1292,CDS,601740,602172,CDS,-1,432,ydgA
1293,gene,602184,602427,gene,-1,243,ydgA
1294,CDS,602184,602427,CDS,-1,243,ydgB
1295,gene,602440,602713,gene,-1,273,ydgB
1296,CDS,602440,602713,CDS,-1,273,ydgC
1298,CDS,603011,603599,CDS,1,588,ydgD
1297,gene,603011,603599,gene,1,588,ydgC
1299,gene,603595,603940,gene,1,345,ydgD
1300,CDS,603595,603940,CDS,1,345,ydgE
1301,gene,604102,604576,gene,1,474,ydgE
1302,CDS,604102,604576,CDS,1,474,vmlR
1303,gene,604735,606379,gene,-1,1644,vmlR
1304,CDS,604735,606379,CDS,-1,1644,ydgF
1305,gene,606698,608075,gene,-1,1377,ydgF
1306,CDS,606698,608075,CDS,-1,1377,dinB
1308,CDS,608245,608764,CDS,-1,519,ydgG
1307,gene,608245,608764,gene,-1,519,dinB
1309,gene,608932,609391,gene,1,459,ydgG
1310,CDS,608932,609391,CDS,1,459,ydgH
1311,gene,609387,612045,gene,1,2658,ydgH
1312,CDS,609387,612045,CDS,1,2658,ydgI
1313,gene,612190,612820,gene,-1,630,ydgI
1314,CDS,612190,612820,CDS,-1,630,ydgJ
1316,CDS,612835,613330,CDS,-1,495,ydgK
1315,gene,612835,613330,gene,-1,495,ydgJ
1317,gene,613640,614849,gene,1,1209,ydgK
1318,CDS,613640,614849,CDS,1,1209,ydhB
1319,gene,614884,615622,gene,-1,738,ydhB
1320,CDS,614884,615622,CDS,-1,738,ydhC
1321,gene,615870,616545,gene,1,675,ydhC
1322,CDS,615870,616545,CDS,1,675,spoL
1323,gene,616671,617934,gene,1,1263,spoL
1324,CDS,616671,617934,CDS,1,1263,ydhE
1326,CDS,618094,619282,CDS,1,1188,ydhF
1325,gene,618094,619282,gene,1,1188,ydhE
1327,gene,619320,620031,gene,-1,711,ydhF
1328,CDS,619320,620031,CDS,-1,711,phoB
1329,gene,620096,621485,gene,-1,1389,phoB
1330,CDS,620096,621485,CDS,-1,1389,fra
1331,gene,621846,622218,gene,1,372,fra
1332,CDS,621846,622218,CDS,1,372,ydhH
1333,gene,622292,622790,gene,-1,498,ydhH
1334,CDS,622292,622790,CDS,-1,498,ydhI
1335,gene,622807,623290,gene,-1,483,ydhI
1336,CDS,622807,623290,CDS,-1,483,ydhJ
1337,gene,623372,624350,gene,1,978,ydhJ
1338,CDS,623372,624350,CDS,1,978,ydhK
1339,gene,624491,625109,gene,1,618,ydhK
1340,CDS,624491,625109,CDS,1,618,pbuE
1342,CDS,625124,626291,CDS,-1,1167,aswA
1341,gene,625124,626291,gene,-1,1167,pbuE
1344,misc_RNA,626345,626446,else,-1,101,gmuB
1343,gene,626345,626446,gene,-1,101,aswA
1345,gene,626621,626933,gene,1,312,gmuB
1346,CDS,626621,626933,CDS,1,312,gmuA
1347,gene,626932,627265,gene,1,333,gmuA
1348,CDS,626932,627265,CDS,1,333,gmuC
1349,gene,627283,628612,gene,1,1329,gmuC
1350,CDS,627283,628612,CDS,1,1329,gmuD
1351,gene,628629,630027,gene,1,1398,gmuD
1352,CDS,628629,630027,CDS,1,1398,gmuR
1353,gene,630169,630883,gene,1,714,gmuR
1354,CDS,630169,630883,CDS,1,714,gmuE
1355,gene,630911,631811,gene,1,900,gmuE
1356,CDS,630911,631811,CDS,1,900,gmuF
1357,gene,631807,632755,gene,1,948,gmuF
1358,CDS,631807,632755,CDS,1,948,gmuG
1360,CDS,632773,633862,CDS,1,1089,ydhUc
1359,gene,632773,633862,gene,1,1089,gmuG
1361,gene,633922,634651,gene,-1,729,ydhUc
1362,misc_feature,633922,634651,else,-1,729,ydhUn
1363,gene,634650,634776,gene,-1,126,ydhUn
1364,misc_feature,634650,634776,else,-1,126,trnE-Arg
1365,gene,635109,635186,gene,1,77,trnE-Arg
1366,tRNA,635109,635186,else,1,77,trnE-Gly
1368,tRNA,635199,635273,else,1,74,rrnE-16S
1367,gene,635199,635273,gene,1,74,trnE-Gly
1369,gene,635432,636987,gene,1,1555,rrnE-16S
1370,rRNA,635432,636987,else,1,1555,rrnE-23S
1371,gene,637154,640082,gene,1,2928,rrnE-23S
1372,rRNA,637154,640082,else,1,2928,rrnE-5S
1373,gene,640137,640254,gene,1,117,rrnE-5S
1374,rRNA,640137,640254,else,1,117,trnE-Met
1375,gene,640267,640344,gene,1,77,trnE-Met
1376,tRNA,640267,640344,else,1,77,trnE-Asp
1378,tRNA,640404,640481,else,1,77,thiL
1377,gene,640404,640481,gene,1,77,trnE-Asp
1379,gene,640661,641639,gene,1,978,thiL
1380,CDS,640661,641639,CDS,1,978,tsaE
1381,gene,641653,642130,gene,1,477,tsaE
1382,CDS,641653,642130,CDS,1,477,tsaB
1383,gene,642110,642800,gene,1,690,tsaB
1384,CDS,642110,642800,CDS,1,690,rimI
1386,CDS,642809,643265,CDS,1,456,tsaD
1385,gene,642809,643265,gene,1,456,rimI
1387,gene,643257,644298,gene,1,1041,tsaD
1388,CDS,643257,644298,CDS,1,1041,ydiF
1389,gene,644527,646456,gene,-1,1929,ydiF
1390,CDS,644527,646456,CDS,-1,1929,moaC
1391,gene,646581,647094,gene,1,513,moaC
1392,CDS,646581,647094,CDS,1,513,rex
1393,gene,647090,647738,gene,1,648,rex
1394,CDS,647090,647738,CDS,1,648,tatAY
1396,CDS,647759,647933,CDS,1,174,tatCY
1395,gene,647759,647933,gene,1,174,tatAY
1397,gene,647939,648704,gene,1,765,tatCY
1398,CDS,647939,648704,CDS,1,765,ydiK
1399,gene,648741,648933,gene,-1,192,ydiK
1400,CDS,648741,648933,CDS,-1,192,ydiL
1401,gene,648929,649664,gene,-1,735,ydiL
1402,CDS,648929,649664,CDS,-1,735,groES
1403,gene,649902,650187,gene,1,285,groES
1404,CDS,649902,650187,CDS,1,285,groEL
1405,gene,650233,651868,gene,1,1635,groEL
1406,CDS,650233,651868,CDS,1,1635,ydzTc
1407,gene,651976,652084,gene,-1,108,ydzTc
1408,misc_feature,651976,652084,else,-1,108,ydzT
1409,gene,652086,652245,gene,-1,159,ydzT
1410,misc_feature,652086,652245,else,-1,159,ydzT
1411,gene,652289,652418,gene,-1,129,ydzT
1412,misc_feature,652289,652418,else,-1,129,ydzT
1413,gene,652510,652720,gene,-1,210,ydzT
1414,misc_feature,652510,652720,else,-1,210,ydzTn
1416,misc_feature,652712,653018,else,-1,306,ydiM
1415,gene,652712,653018,gene,-1,306,ydzTn
1417,gene,653431,653812,gene,1,381,ydiM
1418,CDS,653431,653812,CDS,1,381,ydzU
1419,gene,654070,654343,gene,1,273,ydzU
1420,CDS,654070,654343,CDS,1,273,ydzV
1421,gene,654332,654692,gene,1,360,ydzV
1422,misc_feature,654332,654692,else,1,360,ydiN
1423,gene,654977,655193,gene,1,216,ydiN
1424,misc_feature,654977,655193,else,1,216,bsuMA
1425,gene,655222,656506,gene,1,1284,bsuMA
1426,CDS,655222,656506,CDS,1,1284,bsuMB
1427,gene,656527,657697,gene,1,1170,bsuMB
1428,CDS,656527,657697,CDS,1,1170,ydzWc
1429,gene,657792,658062,gene,-1,270,ydzWc
1430,misc_feature,657792,658062,else,-1,270,ydzWmc
1432,misc_feature,658060,658189,else,-1,129,ydzWmb
1431,gene,658060,658189,gene,-1,129,ydzWmc
1433,gene,658188,658605,gene,-1,417,ydzWmb
1434,misc_feature,658188,658605,else,-1,417,ydzW
1435,gene,658614,658758,gene,-1,144,ydzW
1436,misc_feature,658614,658758,else,-1,144,ydzW
1437,gene,658812,659010,gene,-1,198,ydzW
1438,misc_feature,658812,659010,else,-1,198,ydzWma
1440,misc_feature,659009,659129,else,-1,120,ydzWn
1439,gene,659009,659129,gene,-1,120,ydzWma
1441,gene,659128,659221,gene,-1,93,ydzWn
1442,misc_feature,659128,659221,else,-1,93,bsuRA
1443,gene,659622,660564,gene,1,942,bsuRA
1444,CDS,659622,660564,CDS,1,942,bsuRB
1445,gene,660595,661627,gene,1,1032,bsuRB
1446,CDS,660595,661627,CDS,1,1032,bsuRC
1447,gene,661629,663027,gene,1,1398,bsuRC
1448,CDS,661629,663027,CDS,1,1398,ydjB
1450,CDS,663600,663936,CDS,1,336,ydjC
1449,gene,663600,663936,gene,1,336,ydjB
1451,gene,664318,664669,gene,1,351,ydjC
1452,CDS,664318,664669,CDS,1,351,gutR
1453,gene,664774,667264,gene,-1,2490,gutR
1454,CDS,664774,667264,CDS,-1,2490,gutB
1455,gene,667465,668527,gene,1,1062,gutB
1456,CDS,667465,668527,CDS,1,1062,gutP
1458,CDS,668600,669992,CDS,1,1392,ydjE
1457,gene,668600,669992,gene,1,1392,gutP
1459,gene,670086,671049,gene,1,963,ydjE
1460,CDS,670086,671049,CDS,1,963,pspA
1461,gene,671244,671928,gene,1,684,pspA
1462,CDS,671244,671928,CDS,1,684,ydjG
1463,gene,671993,673019,gene,1,1026,ydjG
1464,CDS,671993,673019,CDS,1,1026,ydjH
1465,gene,673018,673783,gene,1,765,ydjH
1466,CDS,673018,673783,CDS,1,765,ydjI
1468,CDS,673813,674785,CDS,1,972,ydjJ
1467,gene,673813,674785,gene,1,972,ydjI
1469,gene,674831,675857,gene,-1,1026,ydjJ
1470,CDS,674831,675857,CDS,-1,1026,iolT
1471,gene,676441,677863,gene,1,1422,iolT
1472,CDS,676441,677863,CDS,1,1422,bdhA
1473,gene,677910,678951,gene,-1,1041,bdhA
1474,CDS,677910,678951,CDS,-1,1041,walM
1475,gene,679389,679761,gene,1,372,walM
1476,CDS,679389,679761,CDS,1,372,ydjN
1477,gene,679826,680873,gene,1,1047,ydjN
1478,CDS,679826,680873,CDS,1,1047,ydzJ
1479,gene,680906,681065,gene,-1,159,ydzJ
1480,CDS,680906,681065,CDS,-1,159,ydjO
1481,gene,681254,681464,gene,-1,210,ydjO
1482,CDS,681254,681464,CDS,-1,210,ydjP
1483,gene,681546,682362,gene,-1,816,ydjP
1484,CDS,681546,682362,CDS,-1,816,yeaA
1486,CDS,682374,683364,CDS,-1,990,cotA
1485,gene,682374,683364,gene,-1,990,yeaA
1487,gene,683461,685003,gene,-1,1542,cotA
1488,CDS,683461,685003,CDS,-1,1542,gabP
1489,gene,685154,686564,gene,-1,1410,gabP
1490,CDS,685154,686564,CDS,-1,1410,ydzX
1491,gene,686601,686889,gene,-1,288,ydzX
1492,CDS,686601,686889,CDS,-1,288,mneS
1494,CDS,686961,687834,CDS,1,873,yeaC
1493,gene,686961,687834,gene,1,873,mneS
1495,gene,688183,689146,gene,1,963,yeaC
1496,CDS,688183,689146,CDS,1,963,yeaD
1497,gene,689145,690342,gene,1,1197,yeaD
1498,CDS,689145,690342,CDS,1,1197,yebA
1499,gene,690363,692577,gene,1,2214,yebA
1500,CDS,690363,692577,CDS,1,2214,guaA
1502,CDS,692739,694281,CDS,1,1542,gswC
1501,gene,692739,694281,gene,1,1542,guaA
1504,misc_RNA,694424,694527,else,1,103,pbuG
1503,gene,694424,694527,gene,1,103,gswC
1505,gene,694661,695984,gene,1,1323,pbuG
1506,CDS,694661,695984,CDS,1,1323,yebC
1507,gene,696194,696998,gene,1,804,yebC
1508,CDS,696194,696998,CDS,1,804,yebD
1509,gene,697156,697324,gene,1,168,yebD
1510,CDS,697156,697324,CDS,1,168,yebE
1511,gene,697537,698092,gene,1,555,yebE
1512,CDS,697537,698092,CDS,1,555,yebG
1514,CDS,698091,698289,CDS,1,198,gswD
1513,gene,698091,698289,gene,1,198,yebG
1515,gene,698368,698471,gene,1,103,gswD
1516,misc_RNA,698368,698471,else,1,103,purE
1517,gene,698611,699100,gene,1,489,purE
1518,CDS,698611,699100,CDS,1,489,purK
1519,gene,699092,700235,gene,1,1143,purK
1520,CDS,699092,700235,CDS,1,1143,purB
1522,CDS,700231,701527,CDS,1,1296,purC
1521,gene,700231,701527,gene,1,1296,purB
1523,gene,701600,702326,gene,1,726,purC
1524,CDS,701600,702326,CDS,1,726,purS
1525,gene,702318,702573,gene,1,255,purS
1526,CDS,702318,702573,CDS,1,255,purQ
1527,gene,702569,703253,gene,1,684,purQ
1528,CDS,702569,703253,CDS,1,684,purL
1529,gene,703236,705465,gene,1,2229,purL
1530,CDS,703236,705465,CDS,1,2229,purF
1531,gene,705440,706871,gene,1,1431,purF
1532,CDS,705440,706871,CDS,1,1431,purM
1533,gene,706972,708013,gene,1,1041,purM
1534,CDS,706972,708013,CDS,1,1041,purN
1535,gene,708009,708597,gene,1,588,purN
1536,CDS,708009,708597,CDS,1,588,purH
1538,CDS,708593,710132,CDS,1,1539,purD
1537,gene,708593,710132,gene,1,1539,purH
1539,gene,710147,711416,gene,1,1269,purD
1540,CDS,710147,711416,CDS,1,1269,yezC
1541,gene,711455,711875,gene,-1,420,yezC
1542,CDS,711455,711875,CDS,-1,420,yecA
1543,gene,712018,713293,gene,1,1275,yecA
1544,CDS,712018,713293,CDS,1,1275,yezF
1546,CDS,713307,713535,CDS,-1,228,yerA
1545,gene,713307,713535,gene,-1,228,yezF
1547,gene,713663,715406,gene,1,1743,yerA
1548,CDS,713663,715406,CDS,1,1743,yerB
1549,gene,715432,716428,gene,1,996,yerB
1550,CDS,715432,716428,CDS,1,996,yerC
1551,gene,716430,716745,gene,1,315,yerC
1552,CDS,716430,716745,CDS,1,315,yerD
1553,gene,716779,718357,gene,-1,1578,yerD
1554,CDS,716779,718357,CDS,-1,1578,pcrB
1556,CDS,718621,719308,CDS,1,687,pcrA
1555,gene,718621,719308,gene,1,687,pcrB
1558,CDS,719369,721589,CDS,1,2220,ligA
1557,gene,719369,721589,gene,1,2220,pcrA
1559,gene,721612,723619,gene,1,2007,ligA
1560,CDS,721612,723619,CDS,1,2007,yerH
1561,gene,723634,724825,gene,1,1191,yerH
1562,CDS,723634,724825,CDS,1,1191,yerI
1563,gene,724986,725997,gene,1,1011,yerI
1564,CDS,724986,725997,CDS,1,1011,sapB
1565,gene,726034,726733,gene,-1,699,sapB
1566,CDS,726034,726733,CDS,-1,699,opuE
1567,gene,726839,728318,gene,-1,1479,opuE
1568,CDS,726839,728318,CDS,-1,1479,gatC
1569,gene,728731,729022,gene,1,291,gatC
1570,CDS,728731,729022,CDS,1,291,gatA
1571,gene,729037,730495,gene,1,1458,gatA
1572,CDS,729037,730495,CDS,1,1458,gatB
1573,gene,730508,731939,gene,1,1431,gatB
1574,CDS,730508,731939,CDS,1,1431,yerO
1576,CDS,731953,732823,CDS,-1,870,srfP
1575,gene,731953,732823,gene,-1,870,yerO
1577,gene,732954,736113,gene,1,3159,srfP
1578,CDS,732954,736113,CDS,1,3159,dagK
1579,gene,736435,737347,gene,1,912,dagK
1580,CDS,736435,737347,CDS,1,912,rlmCD
1581,gene,737602,738982,gene,1,1380,rlmCD
1582,CDS,737602,738982,CDS,1,1380,yefB
1584,CDS,738994,739897,CDS,-1,903,yefC
1583,gene,738994,739897,gene,-1,903,yefB
1585,gene,739877,740213,gene,1,336,yefC
1586,CDS,739877,740213,CDS,1,336,yeeA
1587,gene,740287,742927,gene,1,2640,yeeA
1588,CDS,740287,742927,CDS,1,2640,yeeB
1589,gene,742938,744738,gene,1,1800,yeeB
1590,CDS,742938,744738,CDS,1,1800,yeeC
1592,CDS,744850,745999,CDS,1,1149,yeeD
1591,gene,744850,745999,gene,1,1149,yeeC
1594,CDS,746260,746566,CDS,-1,306,yezA
1593,gene,746260,746566,gene,-1,306,yeeD
1595,gene,746632,746839,gene,-1,207,yezA
1596,CDS,746632,746839,CDS,-1,207,yezG
1597,gene,747078,747534,gene,-1,456,yezG
1598,CDS,747078,747534,CDS,-1,456,yeeF
1599,gene,747553,749563,gene,-1,2010,yeeF
1600,CDS,747553,749563,CDS,-1,2010,yeeG
1601,gene,749774,750797,gene,1,1023,yeeG
1602,CDS,749774,750797,CDS,1,1023,rapH
1604,CDS,750958,752089,CDS,1,1131,phrH
1603,gene,750958,752089,gene,1,1131,rapH
1605,gene,752078,752252,gene,1,174,phrH
1606,CDS,752078,752252,CDS,1,174,yeeI
1607,gene,752411,753131,gene,1,720,yeeI
1608,CDS,752411,753131,CDS,1,720,cotK
1609,gene,753264,753702,gene,1,438,cotK
1610,CDS,753264,753702,CDS,1,438,yezE
1612,CDS,753816,754401,CDS,1,585,yesE
1611,gene,753816,754401,gene,1,585,yezE
1613,gene,754479,754923,gene,1,444,yesE
1614,CDS,754479,754923,CDS,1,444,yesF
1615,gene,754919,755780,gene,1,861,yesF
1616,CDS,754919,755780,CDS,1,861,cotJA
1617,gene,755906,756155,gene,1,249,cotJA
1618,CDS,755906,756155,CDS,1,249,cotJB
1619,gene,756138,756402,gene,1,264,cotJB
1620,CDS,756138,756402,CDS,1,264,cotJC
1621,gene,756416,756986,gene,1,570,cotJC
1622,CDS,756416,756986,CDS,1,570,yesJ
1623,gene,757110,757653,gene,1,543,yesJ
1624,CDS,757110,757653,CDS,1,543,yesK
1625,gene,757675,757978,gene,1,303,yesK
1626,CDS,757675,757978,CDS,1,303,yesL
1628,CDS,758092,758722,CDS,1,630,yesM
1627,gene,758092,758722,gene,1,630,yesL
1629,gene,758718,760452,gene,1,1734,yesM
1630,CDS,758718,760452,CDS,1,1734,yesN
1631,gene,760451,761558,gene,1,1107,yesN
1632,CDS,760451,761558,CDS,1,1107,yesO
1633,gene,761661,762945,gene,1,1284,yesO
1634,CDS,761661,762945,CDS,1,1284,rhgP
1635,gene,762941,763871,gene,1,930,rhgP
1636,CDS,762941,763871,CDS,1,930,rhgQ
1637,gene,763874,764765,gene,1,891,rhgQ
1638,CDS,763874,764765,CDS,1,891,rhgH
1639,gene,764780,765815,gene,1,1035,rhgH
1640,CDS,764780,765815,CDS,1,1035,rhgR
1641,gene,765837,768123,gene,1,2286,rhgR
1642,CDS,765837,768123,CDS,1,2286,rhgT
1644,CDS,768136,768835,CDS,1,699,yesU
1643,gene,768136,768835,gene,1,699,rhgT
1645,gene,768827,769490,gene,1,663,yesU
1646,CDS,768827,769490,CDS,1,663,yesV
1647,gene,769486,770113,gene,1,627,yesV
1648,CDS,769486,770113,CDS,1,627,rhgW
1649,gene,770233,772096,gene,1,1863,rhgW
1650,CDS,770233,772096,CDS,1,1863,rhgX
1652,CDS,772141,773980,CDS,1,1839,yesY
1651,gene,772141,773980,gene,1,1839,rhgX
1653,gene,774137,774791,gene,1,654,yesY
1654,CDS,774137,774791,CDS,1,654,rhgZ
1655,gene,774798,776790,gene,1,1992,rhgZ
1656,CDS,774798,776790,CDS,1,1992,yetA
1657,gene,776833,779407,gene,1,2574,yetA
1658,CDS,776833,779407,CDS,1,2574,lplA
1659,gene,779528,781037,gene,1,1509,lplA
1660,CDS,779528,781037,CDS,1,1509,lplB
1662,CDS,781091,782048,CDS,1,957,lplC
1661,gene,781091,782048,gene,1,957,lplB
1663,gene,782061,782949,gene,1,888,lplC
1664,CDS,782061,782949,CDS,1,888,lplD
1665,gene,782957,784298,gene,1,1341,lplD
1666,CDS,782957,784298,CDS,1,1341,yetF
1667,gene,784380,785076,gene,1,696,yetF
1668,CDS,784380,785076,CDS,1,696,hmoA
1670,CDS,785112,785439,CDS,-1,327,yetH
1669,gene,785112,785439,gene,-1,327,hmoA
1671,gene,785542,785905,gene,-1,363,yetH
1672,CDS,785542,785905,CDS,-1,363,yetI
1673,gene,786688,787264,gene,1,576,yetI
1674,misc_feature,786688,787264,else,1,576,yetI
1675,gene,787263,787560,gene,1,297,yetI
1676,misc_feature,787263,787560,else,1,297,yezD
1677,gene,787714,787882,gene,1,168,yezD
1678,CDS,787714,787882,CDS,1,168,calJ
1680,CDS,787991,788636,CDS,1,645,yetK
1679,gene,787991,788636,gene,1,645,calJ
1681,gene,788635,789628,gene,1,993,yetK
1682,CDS,788635,789628,CDS,1,993,flvL
1683,gene,789651,790155,gene,-1,504,flvL
1684,CDS,789651,790155,CDS,-1,504,flvM
1685,gene,790317,791427,gene,1,1110,flvM
1686,CDS,790317,791427,CDS,1,1110,yetN
1687,gene,791461,792532,gene,-1,1071,yetN
1688,CDS,791461,792532,CDS,-1,1071,cypD
1689,gene,792681,795867,gene,1,3186,cypD
1690,CDS,792681,795867,CDS,1,3186,ltaSA
1691,gene,796313,798233,gene,1,1920,ltaSA
1692,CDS,796313,798233,CDS,1,1920,spmH
1693,gene,798468,799233,gene,1,765,spmH
1694,CDS,798468,799233,CDS,1,765,spmG
1695,gene,799239,800208,gene,1,969,spmG
1696,CDS,799239,800208,CDS,1,969,yfnF
1697,gene,800231,801143,gene,1,912,yfnF
1698,CDS,800231,801143,CDS,1,912,yfnE
1700,CDS,801171,802350,CDS,1,1179,yfnD
1699,gene,801171,802350,gene,1,1179,yfnE
1701,gene,802350,803286,gene,1,936,yfnD
1702,CDS,802350,803286,CDS,1,936,yfnC
1703,gene,803316,804546,gene,-1,1230,yfnC
1704,CDS,803316,804546,CDS,-1,1230,pynN
1705,gene,804656,805364,gene,-1,708,pynN
1706,CDS,804656,805364,CDS,-1,708,mtrA
1707,gene,805455,806841,gene,-1,1386,mtrA
1708,CDS,805455,806841,CDS,-1,1386,vdhT
1709,gene,807090,808548,gene,1,1458,vdhT
1710,CDS,807090,808548,CDS,1,1458,yfmS
1711,gene,808561,809422,gene,1,861,yfmS
1712,CDS,808561,809422,CDS,1,861,ettA
1713,gene,809556,811446,gene,1,1890,ettA
1714,CDS,809556,811446,CDS,1,1890,yfmQ
1716,CDS,811568,812015,CDS,1,447,copP
1715,gene,811568,812015,gene,1,447,yfmQ
1717,gene,812139,812562,gene,1,423,copP
1718,CDS,812139,812562,CDS,1,423,copO
1719,gene,812627,813818,gene,1,1191,copO
1720,CDS,812627,813818,CDS,1,1191,yfmN
1721,gene,814108,814264,gene,1,156,yfmN
1722,CDS,814108,814264,CDS,1,156,ettM
1724,CDS,814383,815940,CDS,-1,1557,yfmL
1723,gene,814383,815940,gene,-1,1557,ettM
1725,gene,816112,817243,gene,1,1131,yfmL
1726,CDS,816112,817243,CDS,1,1131,yfmK
1727,gene,817310,817757,gene,1,447,yfmK
1728,CDS,817310,817757,CDS,1,447,yfmJ
1729,gene,817809,818829,gene,-1,1020,yfmJ
1730,CDS,817809,818829,CDS,-1,1020,yfmI
1731,gene,819310,820531,gene,-1,1221,yfmI
1732,CDS,819310,820531,CDS,-1,1221,yfmG
1734,CDS,820866,822330,CDS,1,1464,fecF
1733,gene,820866,822330,gene,1,1464,yfmG
1735,gene,822902,823703,gene,-1,801,fecF
1736,CDS,822902,823703,CDS,-1,801,fecE
1737,gene,823715,824717,gene,-1,1002,fecE
1738,CDS,823715,824717,CDS,-1,1002,fecD
1739,gene,824713,825715,gene,-1,1002,fecD
1740,CDS,824713,825715,CDS,-1,1002,fecC
1742,CDS,825786,826734,CDS,-1,948,yfmB
1741,gene,825786,826734,gene,-1,948,fecC
1743,gene,826842,827211,gene,-1,369,yfmB
1744,CDS,826842,827211,CDS,-1,369,yflT
1745,gene,827454,827802,gene,1,348,yflT
1746,CDS,827454,827802,CDS,1,348,pelA
1747,gene,827992,829255,gene,1,1263,pelA
1748,CDS,827992,829255,CDS,1,1263,maeS
1749,gene,829381,830818,gene,1,1437,maeS
1750,CDS,829381,830818,CDS,1,1437,citS
1752,CDS,830944,832573,CDS,1,1629,citT
1751,gene,830944,832573,gene,1,1629,citS
1753,gene,832544,833225,gene,1,681,citT
1754,CDS,832544,833225,CDS,1,681,yflP
1755,gene,833227,834187,gene,1,960,yflP
1756,CDS,833227,834187,CDS,1,960,citM
1757,gene,834382,835684,gene,1,1302,citM
1758,CDS,834382,835684,CDS,1,1302,yflN
1759,gene,835739,836534,gene,1,795,yflN
1760,CDS,835739,836534,CDS,1,795,nosA
1761,gene,836652,837744,gene,1,1092,nosA
1762,CDS,836652,837744,CDS,1,1092,acyP
1763,gene,837734,838010,gene,-1,276,acyP
1764,CDS,837734,838010,CDS,-1,276,yflK
1765,gene,838076,838742,gene,1,666,yflK
1766,CDS,838076,838742,CDS,1,666,yflJ
1767,gene,838782,838920,gene,-1,138,yflJ
1768,CDS,838782,838920,CDS,-1,138,yflI
1770,CDS,839076,839232,CDS,-1,156,yflH
1769,gene,839076,839232,gene,-1,156,yflI
1771,gene,839338,839653,gene,-1,315,yflH
1772,CDS,839338,839653,CDS,-1,315,mapB
1773,gene,839734,840484,gene,-1,750,mapB
1774,CDS,839734,840484,CDS,-1,750,nagP
1775,gene,840655,842014,gene,1,1359,nagP
1776,CDS,840655,842014,CDS,1,1359,ltaSB
1778,CDS,842046,843996,CDS,-1,1950,yflD
1777,gene,842046,843996,gene,-1,1950,ltaSB
1779,gene,844096,844234,gene,1,138,yflD
1780,CDS,844096,844234,CDS,1,138,yflB
1781,gene,844252,844645,gene,1,393,yflB
1782,CDS,844252,844645,CDS,1,393,yflA
1783,gene,844769,846185,gene,1,1416,yflA
1784,CDS,844769,846185,CDS,1,1416,yfkT
1786,CDS,846181,847258,CDS,-1,1077,yfkS
1785,gene,846181,847258,gene,-1,1077,yfkT
1788,CDS,847281,847482,CDS,-1,201,yfkR
1787,gene,847281,847482,gene,-1,201,yfkS
1789,gene,847497,848652,gene,-1,1155,yfkR
1790,CDS,847497,848652,CDS,-1,1155,yfkQ
1791,gene,848632,850174,gene,-1,1542,yfkQ
1792,CDS,848632,850174,CDS,-1,1542,treP
1793,gene,850366,851779,gene,1,1413,treP
1794,CDS,850366,851779,CDS,1,1413,treA
1795,gene,851849,853535,gene,1,1686,treA
1796,CDS,851849,853535,CDS,1,1686,treR
1798,CDS,853555,854272,CDS,1,717,hypO
1797,gene,853555,854272,gene,1,717,treR
1799,gene,854411,855077,gene,1,666,hypO
1800,CDS,854411,855077,CDS,1,666,yfkN
1801,gene,855113,859502,gene,-1,4389,yfkN
1802,CDS,855113,859502,CDS,-1,4389,sufLB
1803,gene,859744,860263,gene,1,519,sufLB
1804,CDS,859744,860263,CDS,1,519,yfkL
1806,CDS,860302,861493,CDS,-1,1191,yfkK
1805,gene,860302,861493,gene,-1,1191,yfkL
1807,gene,861585,861801,gene,-1,216,yfkK
1808,CDS,861585,861801,CDS,-1,216,yfkJ
1809,gene,862003,862474,gene,1,471,yfkJ
1810,CDS,862003,862474,CDS,1,471,yfkI
1811,gene,862491,862812,gene,1,321,yfkI
1812,CDS,862491,862812,CDS,1,321,rbn
1813,gene,862835,863663,gene,1,828,rbn
1814,CDS,862835,863663,CDS,1,828,yfkF
1815,gene,863861,865037,gene,-1,1176,yfkF
1816,CDS,863861,865037,CDS,-1,1176,chaA
1817,gene,865204,866260,gene,1,1056,chaA
1818,CDS,865204,866260,CDS,1,1056,yfkD
1819,gene,866330,867125,gene,1,795,yfkD
1820,CDS,866330,867125,CDS,1,795,mscC
1822,CDS,867163,868006,CDS,-1,843,yfkA
1821,gene,867163,868006,gene,-1,843,mscC
1823,gene,868006,869128,gene,-1,1122,yfkA
1824,CDS,868006,869128,CDS,-1,1122,yfjT
1825,gene,869272,869458,gene,1,186,yfjT
1826,CDS,869272,869458,CDS,1,186,pdaA
1827,gene,869558,870350,gene,1,792,pdaA
1828,CDS,869558,870350,CDS,1,792,yfjR
1830,CDS,870387,871248,CDS,-1,861,yfjQ
1829,gene,870387,871248,gene,-1,861,yfjR
1831,gene,871346,872306,gene,-1,960,yfjQ
1832,CDS,871346,872306,CDS,-1,960,yfjP
1833,gene,872424,873288,gene,1,864,yfjP
1834,CDS,872424,873288,CDS,1,864,yfjO
1835,gene,873401,874802,gene,1,1401,yfjO
1836,CDS,873401,874802,CDS,1,1401,yfzA
1837,gene,875427,875694,gene,1,267,yfzA
1838,CDS,875427,875694,CDS,1,267,dusC
1840,CDS,876425,877403,CDS,1,978,yfjM
1839,gene,876425,877403,gene,1,978,dusC
1842,CDS,877598,878051,CDS,1,453,yfjL
1841,gene,877598,878051,gene,1,453,yfjM
1843,gene,878080,878770,gene,1,690,yfjL
1844,CDS,878080,878770,CDS,1,690,acoA
1845,gene,879001,880003,gene,1,1002,acoA
1846,CDS,879001,880003,CDS,1,1002,acoB
1847,gene,880006,881035,gene,1,1029,acoB
1848,CDS,880006,881035,CDS,1,1029,acoC
1849,gene,881048,882245,gene,1,1197,acoC
1850,CDS,881048,882245,CDS,1,1197,acoL
1852,CDS,882265,883642,CDS,1,1377,acoR
1851,gene,882265,883642,gene,1,1377,acoL
1853,gene,883757,885575,gene,1,1818,acoR
1854,CDS,883757,885575,CDS,1,1818,sspH
1855,gene,885628,885808,gene,1,180,sspH
1856,CDS,885628,885808,CDS,1,180,yfjF
1857,gene,885843,886173,gene,-1,330,yfjF
1858,CDS,885843,886173,CDS,-1,330,yfjE
1860,CDS,886222,886681,CDS,-1,459,yfjD
1859,gene,886222,886681,gene,-1,459,yfjE
1861,gene,886774,887332,gene,-1,558,yfjD
1862,CDS,886774,887332,CDS,-1,558,yfjC
1863,gene,887363,888131,gene,-1,768,yfjC
1864,CDS,887363,888131,CDS,-1,768,yfjB
1865,gene,888142,889366,gene,-1,1224,yfjB
1866,CDS,888142,889366,CDS,-1,1224,yfjA
1867,gene,889371,889686,gene,-1,315,yfjA
1868,CDS,889371,889686,CDS,-1,315,malA
1869,gene,890021,891371,gene,1,1350,malA
1870,CDS,890021,891371,CDS,1,1350,malR
1871,gene,891435,892200,gene,1,765,malR
1872,CDS,891435,892200,CDS,1,765,malP
1873,gene,892214,893798,gene,1,1584,malP
1874,CDS,892214,893798,CDS,1,1584,yfiB
1875,gene,893903,895625,gene,1,1722,yfiB
1876,CDS,893903,895625,CDS,1,1722,yfiC
1878,CDS,895618,897433,CDS,1,1815,catD
1877,gene,895618,897433,gene,1,1815,yfiC
1879,gene,897587,897992,gene,1,405,catD
1880,CDS,897587,897992,CDS,1,405,catE
1881,gene,898009,898867,gene,1,858,catE
1882,CDS,898009,898867,CDS,1,858,yfiF
1883,gene,898960,899905,gene,1,945,yfiF
1884,CDS,898960,899905,CDS,1,945,yfiG
1886,CDS,900079,901528,CDS,1,1449,yfiH
1885,gene,900079,901528,gene,1,1449,yfiG
1887,gene,901554,902496,gene,1,942,yfiH
1888,CDS,901554,902496,CDS,1,942,yfiI
1889,gene,902505,903687,gene,1,1182,yfiI
1890,CDS,902505,903687,CDS,1,1182,linJ
1891,gene,903810,905013,gene,1,1203,linJ
1892,CDS,903810,905013,CDS,1,1203,linK
1893,gene,905009,905672,gene,1,663,linK
1894,CDS,905009,905672,CDS,1,663,bifL
1896,CDS,905815,906751,CDS,1,936,bifM
1895,gene,905815,906751,gene,1,936,bifL
1897,gene,906763,907954,gene,1,1191,bifM
1898,CDS,906763,907954,CDS,1,1191,bifN
1899,gene,907967,909125,gene,1,1158,bifN
1900,CDS,907967,909125,CDS,1,1158,padR
1901,gene,909197,909746,gene,-1,549,padR
1902,CDS,909197,909746,CDS,-1,549,estB
1903,gene,910018,910651,gene,1,633,estB
1904,CDS,910018,910651,CDS,1,633,icaC
1905,gene,910839,911928,gene,1,1089,icaC
1906,CDS,910839,911928,CDS,1,1089,yfiR
1907,gene,911963,912581,gene,-1,618,yfiR
1908,CDS,911963,912581,CDS,-1,618,yfiS
1909,gene,912546,913800,gene,-1,1254,yfiS
1910,CDS,912546,913800,CDS,-1,1254,bstA
1912,CDS,913923,914460,CDS,1,537,yfiU
1911,gene,913923,914460,gene,1,537,bstA
1914,CDS,914456,916013,CDS,-1,1557,yfiV
1913,gene,914456,916013,gene,-1,1557,yfiU
1915,gene,916123,916606,gene,-1,483,yfiV
1916,CDS,916123,916606,CDS,-1,483,mprF
1917,gene,916777,919348,gene,1,2571,mprF
1918,CDS,916777,919348,CDS,1,2571,sxzY
1919,gene,919365,920343,gene,-1,978,sxzY
1920,CDS,919365,920343,CDS,-1,978,sxzZ
1921,gene,920473,921475,gene,1,1002,sxzZ
1922,CDS,920473,921475,CDS,1,1002,sxzA
1923,gene,921471,922503,gene,1,1032,sxzA
1924,CDS,921471,922503,CDS,1,1032,yfhB
1925,gene,922617,923499,gene,1,882,yfhB
1926,CDS,922617,923499,CDS,1,882,yfhC
1927,gene,923586,924171,gene,1,585,yfhC
1928,CDS,923586,924171,CDS,1,585,yfhD
1929,gene,924209,924401,gene,-1,192,yfhD
1930,CDS,924209,924401,CDS,-1,192,yfhE
1932,CDS,924467,924578,CDS,-1,111,yfhF
1931,gene,924467,924578,gene,-1,111,yfhE
1933,gene,924632,925544,gene,-1,912,yfhF
1934,CDS,924632,925544,CDS,-1,912,recX
1935,gene,925632,926427,gene,1,795,recX
1936,CDS,925632,926427,CDS,1,795,yfhH
1937,gene,926428,926743,gene,1,315,yfhH
1938,CDS,926428,926743,CDS,1,315,yfhI
1940,CDS,926885,928079,CDS,1,1194,sspK
1939,gene,926885,928079,gene,1,1194,yfhI
1941,gene,928111,928264,gene,-1,153,sspK
1942,CDS,928111,928264,CDS,-1,153,yfhJ
1943,gene,928388,928658,gene,1,270,yfhJ
1944,CDS,928388,928658,CDS,1,270,yfhK
1945,gene,928802,929321,gene,1,519,yfhK
1946,CDS,928802,929321,CDS,1,519,spdL
1948,CDS,929405,929738,CDS,1,333,ephM
1947,gene,929405,929738,gene,1,333,spdL
1950,CDS,929724,930585,CDS,1,861,csbB
1949,gene,929724,930585,gene,1,861,ephM
1951,gene,930817,931807,gene,1,990,csbB
1952,CDS,930817,931807,CDS,1,990,yfhO
1953,gene,931878,934464,gene,1,2586,yfhO
1954,CDS,931878,934464,CDS,1,2586,yfhP
1955,gene,934456,935440,gene,-1,984,yfhP
1956,CDS,934456,935440,CDS,-1,984,mutY
1957,gene,935655,936765,gene,1,1110,mutY
1958,CDS,935655,936765,CDS,1,1110,yfhS
1960,CDS,936772,936997,CDS,-1,225,fabL
1959,gene,936772,936997,gene,-1,225,yfhS
1961,gene,937078,937831,gene,1,753,fabL
1962,CDS,937078,937831,CDS,1,753,sspE
1963,gene,937899,938154,gene,1,255,sspE
1964,CDS,937899,938154,CDS,1,255,ygaB
1965,gene,938242,938587,gene,1,345,ygaB
1966,CDS,938242,938587,CDS,1,345,ygaC
1968,CDS,938730,939261,CDS,1,531,ygaD
1967,gene,938730,939261,gene,1,531,ygaC
1969,gene,939348,941091,gene,1,1743,ygaD
1970,CDS,939348,941091,CDS,1,1743,ygaE
1971,gene,941167,942229,gene,-1,1062,ygaE
1972,CDS,941167,942229,CDS,-1,1062,gsaB
1973,gene,942448,943738,gene,-1,1290,gsaB
1974,CDS,942448,943738,CDS,-1,1290,bcp
1975,gene,943890,944364,gene,1,474,bcp
1976,CDS,943890,944364,CDS,1,474,perR
1977,gene,944486,944924,gene,1,438,perR
1978,CDS,944486,944924,CDS,1,438,ygzB
1979,gene,944958,945312,gene,-1,354,ygzB
1980,CDS,944958,945312,CDS,-1,354,ygxA
1981,gene,945519,946404,gene,1,885,ygxA
1982,CDS,945519,946404,CDS,1,885,rrnD-16S
1984,rRNA,946695,948250,else,1,1555,rrnD-23S
1983,gene,946695,948250,gene,1,1555,rrnD-16S
1985,gene,948417,951345,gene,1,2928,rrnD-23S
1986,rRNA,948417,951345,else,1,2928,rrnD-5S
1987,gene,951456,951572,gene,1,116,rrnD-5S
1988,rRNA,951456,951572,else,1,116,asnTA
1989,gene,951581,951656,gene,1,75,asnTA
1990,tRNA,951581,951656,else,1,75,trnD-Ser
1991,gene,951661,951753,gene,1,92,trnD-Ser
1992,tRNA,951661,951753,else,1,92,trnD-Glu
1993,gene,951787,951859,gene,1,72,trnD-Glu
1994,tRNA,951787,951859,else,1,72,trnD-Val
1995,gene,951868,951944,gene,1,76,trnD-Val
1996,tRNA,951868,951944,else,1,76,trnD-Met
1997,gene,951953,952030,gene,1,77,trnD-Met
1998,tRNA,951953,952030,else,1,77,trnD-Asp
1999,gene,952041,952118,gene,1,77,trnD-Asp
2000,tRNA,952041,952118,else,1,77,trnD-Phe
2002,tRNA,952130,952206,else,1,76,trnD-Thr
2001,gene,952130,952206,gene,1,76,trnD-Phe
2003,gene,952211,952284,gene,1,73,trnD-Thr
2004,tRNA,952211,952284,else,1,73,trnD-Tyr
2005,gene,952306,952391,gene,1,85,trnD-Tyr
2006,tRNA,952306,952391,else,1,85,trnD-Trp
2007,gene,952396,952470,gene,1,74,trnD-Trp
2008,tRNA,952396,952470,else,1,74,trnD-His
2010,tRNA,952494,952570,else,1,76,trnD-Gln
2009,gene,952494,952570,gene,1,76,trnD-His
2011,gene,952579,952651,gene,1,72,trnD-Gln
2012,tRNA,952579,952651,else,1,72,glyTB
2013,gene,952700,952775,gene,1,75,glyTB
2014,tRNA,952700,952775,else,1,75,cysTA
2015,gene,952780,952851,gene,1,71,cysTA
2016,tRNA,952780,952851,else,1,71,leuTA
2018,tRNA,952858,952947,else,1,89,leuTB
2017,gene,952858,952947,gene,1,89,leuTA
2020,tRNA,953212,953294,else,1,82,spo0M
2019,gene,953212,953294,gene,1,82,leuTB
2021,gene,953372,954149,gene,-1,777,spo0M
2022,CDS,953372,954149,CDS,-1,777,ygzA
2023,gene,954290,954494,gene,1,204,ygzA
2024,CDS,954290,954494,CDS,1,204,ygzC
2025,gene,954578,954851,gene,-1,273,ygzC
2026,CDS,954578,954851,CDS,-1,273,ygaJ
2027,gene,954892,955585,gene,1,693,ygaJ
2028,CDS,954892,955585,CDS,1,693,tswD
2030,misc_RNA,955654,955762,else,1,108,thiC
2029,gene,955654,955762,gene,1,108,tswD
2031,gene,955894,957667,gene,1,1773,thiC
2032,CDS,955894,957667,CDS,1,1773,ygaK
2033,gene,957704,959060,gene,-1,1356,ygaK
2034,CDS,957704,959060,CDS,-1,1356,senS
2035,gene,959310,959508,gene,1,198,senS
2036,CDS,959310,959508,CDS,1,198,katA
2038,CDS,959534,960986,CDS,-1,1452,ssuB
2037,gene,959534,960986,gene,-1,1452,katA
2039,gene,961393,962161,gene,1,768,ssuB
2040,CDS,961393,962161,CDS,1,768,ssuA
2041,gene,962178,963177,gene,1,999,ssuA
2042,CDS,962178,963177,CDS,1,999,ssuC
2043,gene,963173,964004,gene,1,831,ssuC
2044,CDS,963173,964004,CDS,1,831,ssuD
2045,gene,964026,965157,gene,1,1131,ssuD
2046,CDS,964026,965157,CDS,1,1131,ygaN
2047,gene,965260,965797,gene,1,537,ygaN
2048,CDS,965260,965797,CDS,1,537,rpsNB
2049,gene,965908,966178,gene,1,270,rpsNB
2050,CDS,965908,966178,CDS,1,270,ygaO
2051,gene,966195,966669,gene,-1,474,ygaO
2052,CDS,966195,966669,CDS,-1,474,ygzD
2054,CDS,966670,966871,CDS,-1,201,trnSL-Gly1
2053,gene,966670,966871,gene,-1,201,ygzD
2055,gene,967064,967138,gene,1,74,trnSL-Gly1
2056,tRNA,967064,967138,else,1,74,yhzB
2057,gene,967228,967852,gene,-1,624,yhzB
2058,CDS,967228,967852,CDS,-1,624,queG
2059,gene,967934,969095,gene,1,1161,queG
2060,CDS,967934,969095,CDS,1,1161,yhbB
2061,gene,969161,970097,gene,1,936,yhbB
2062,CDS,969161,970097,CDS,1,936,trmL
2063,gene,970134,970617,gene,1,483,trmL
2064,CDS,970134,970617,CDS,1,483,yhbD
2065,gene,970666,971383,gene,1,717,yhbD
2066,CDS,970666,971383,CDS,1,717,yhbE
2067,gene,971373,972087,gene,1,714,yhbE
2068,CDS,971373,972087,CDS,1,714,yhbF
2070,CDS,972098,972806,CDS,1,708,prkA
2069,gene,972098,972806,gene,1,708,yhbF
2071,gene,973155,975051,gene,1,1896,prkA
2072,CDS,973155,975051,CDS,1,1896,yhbH
2073,gene,975230,976409,gene,1,1179,yhbH
2074,CDS,975230,976409,CDS,1,1179,yhbI
2075,gene,976568,977033,gene,1,465,yhbI
2076,CDS,976568,977033,CDS,1,465,yhbJ
2078,CDS,977068,977734,CDS,1,666,yhcA
2077,gene,977068,977734,gene,1,666,yhbJ
2079,gene,977774,979373,gene,1,1599,yhcA
2080,CDS,977774,979373,CDS,1,1599,yhcB
2081,gene,979395,979926,gene,1,531,yhcB
2082,CDS,979395,979926,CDS,1,531,yhcC
2083,gene,979938,980313,gene,1,375,yhcC
2084,CDS,979938,980313,CDS,1,375,yhcD
2085,gene,980312,980468,gene,1,156,yhcD
2086,CDS,980312,980468,CDS,1,156,yhcE
2088,CDS,980472,981234,CDS,1,762,yhcF
2087,gene,980472,981234,gene,1,762,yhcE
2089,gene,981236,981602,gene,1,366,yhcF
2090,CDS,981236,981602,CDS,1,366,yhcG
2091,gene,981603,982302,gene,1,699,yhcG
2092,CDS,981603,982302,CDS,1,699,yhcH
2093,gene,982318,983236,gene,1,918,yhcH
2094,CDS,982318,983236,CDS,1,918,yhcI
2096,CDS,983228,984170,CDS,1,942,cspB
2095,gene,983228,984170,gene,1,942,yhcI
2097,gene,984261,984465,gene,-1,204,cspB
2098,CDS,984261,984465,CDS,-1,204,yhcJ
2099,gene,984900,985731,gene,1,831,yhcJ
2100,CDS,984900,985731,CDS,1,831,dgcK
2101,gene,985733,986813,gene,-1,1080,dgcK
2102,CDS,985733,986813,CDS,-1,1080,tcyP
2103,gene,986985,988377,gene,1,1392,tcyP
2104,CDS,986985,988377,CDS,1,1392,yhcM
2106,CDS,988416,988872,CDS,-1,456,yhcN
2105,gene,988416,988872,gene,-1,456,yhcM
2107,gene,989021,989591,gene,1,570,yhcN
2108,CDS,989021,989591,CDS,1,570,yhcO
2109,gene,989711,990680,gene,1,969,yhcO
2110,CDS,989711,990680,CDS,1,969,yhcQ
2111,gene,990611,991265,gene,-1,654,yhcQ
2112,CDS,990611,991265,CDS,-1,654,mncR
2113,gene,991347,995001,gene,1,3654,mncR
2114,CDS,991347,995001,CDS,1,3654,srtA
2115,gene,994997,995594,gene,1,597,srtA
2116,CDS,994997,995594,CDS,1,597,yhcT
2117,gene,995623,996532,gene,-1,909,yhcT
2118,CDS,995623,996532,CDS,-1,909,yhcU
2119,gene,996642,997038,gene,1,396,yhcU
2120,CDS,996642,997038,CDS,1,396,yhcV
2121,gene,997174,997597,gene,1,423,yhcV
2122,CDS,997174,997597,CDS,1,423,glpW
2124,CDS,997723,998386,CDS,1,663,yhcX
2123,gene,997723,998386,gene,1,663,glpW
2125,gene,998401,999943,gene,1,1542,yhcX
2126,CDS,998401,999943,CDS,1,1542,yhzG
2127,gene,1000026,1000218,gene,1,192,yhzG
2128,misc_feature,1000026,1000218,else,1,192,yhxA
2129,gene,1000363,1001716,gene,1,1353,yhxA
2130,CDS,1000363,1001716,CDS,1,1353,glpP
2131,gene,1001743,1002322,gene,1,579,glpP
2132,CDS,1001743,1002322,CDS,1,579,glpF
2133,gene,1002500,1003325,gene,1,825,glpF
2134,CDS,1002500,1003325,CDS,1,825,glpK
2135,gene,1003343,1004834,gene,1,1491,glpK
2136,CDS,1003343,1004834,CDS,1,1491,glpD
2137,gene,1004974,1006642,gene,1,1668,glpD
2138,CDS,1004974,1006642,CDS,1,1668,pgcA
2140,CDS,1006773,1008519,CDS,1,1746,yhcY
2139,gene,1006773,1008519,gene,1,1746,pgcA
2141,gene,1008667,1009807,gene,1,1140,yhcY
2142,CDS,1008667,1009807,CDS,1,1140,yhcZ
2143,gene,1009803,1010448,gene,1,645,yhcZ
2144,CDS,1009803,1010448,CDS,1,645,azr
2145,gene,1010444,1010969,gene,1,525,azr
2146,CDS,1010444,1010969,CDS,1,525,yhdB
2148,CDS,1010983,1011226,CDS,-1,243,yhdC
2147,gene,1010983,1011226,gene,-1,243,yhdB
2149,gene,1011426,1011750,gene,1,324,yhdC
2150,CDS,1011426,1011750,CDS,1,324,lytF
2151,gene,1011791,1013258,gene,-1,1467,lytF
2152,CDS,1011791,1013258,CDS,-1,1467,nsrR
2153,gene,1013410,1013851,gene,-1,441,nsrR
2154,CDS,1013410,1013851,CDS,-1,441,ygxB
2155,gene,1013957,1015616,gene,-1,1659,ygxB
2156,CDS,1013957,1015616,CDS,-1,1659,spoVR
2158,CDS,1015646,1017053,CDS,1,1407,phoA
2157,gene,1015646,1017053,gene,1,1407,spoVR
2159,gene,1017082,1018468,gene,-1,1386,phoA
2160,CDS,1017082,1018468,CDS,-1,1386,lytE
2161,gene,1018997,1020002,gene,1,1005,lytE
2162,CDS,1018997,1020002,CDS,1,1005,citR
2163,gene,1020072,1020948,gene,-1,876,citR
2164,CDS,1020072,1020948,CDS,-1,876,citA
2166,CDS,1021056,1022157,CDS,1,1101,yhdF
2165,gene,1021056,1022157,gene,1,1101,citA
2167,gene,1022230,1023100,gene,1,870,yhdF
2168,CDS,1022230,1023100,CDS,1,870,bcaP
2169,gene,1023349,1024747,gene,1,1398,bcaP
2170,CDS,1023349,1024747,CDS,1,1398,yhdH
2171,gene,1024864,1026220,gene,1,1356,yhdH
2172,CDS,1024864,1026220,CDS,1,1356,yhdI
2173,gene,1026254,1027664,gene,-1,1410,yhdI
2174,CDS,1026254,1027664,CDS,-1,1410,yhdJ
2176,CDS,1027773,1028202,CDS,1,429,asiMB
2175,gene,1027773,1028202,gene,1,429,yhdJ
2177,gene,1028232,1028523,gene,-1,291,asiMB
2178,CDS,1028232,1028523,CDS,-1,291,asiMA
2179,gene,1028510,1029587,gene,-1,1077,asiMA
2180,CDS,1028510,1029587,CDS,-1,1077,sigM
2181,gene,1029576,1030068,gene,-1,492,sigM
2182,CDS,1029576,1030068,CDS,-1,492,akrN
2183,gene,1030264,1031260,gene,1,996,akrN
2184,CDS,1030264,1031260,CDS,1,996,plsC
2185,gene,1031394,1031994,gene,1,600,plsC
2186,CDS,1031394,1031994,CDS,1,600,yhdP
2187,gene,1032062,1033397,gene,-1,1335,yhdP
2188,CDS,1032062,1033397,CDS,-1,1335,cueR
2189,gene,1033457,1033889,gene,-1,432,cueR
2190,CDS,1033457,1033889,CDS,-1,432,yhdR
2192,CDS,1034045,1035227,CDS,1,1182,yhdT
2191,gene,1034045,1035227,gene,1,1182,yhdR
2194,CDS,1035553,1036939,CDS,1,1386,crcBA
2193,gene,1035553,1036939,gene,1,1386,yhdT
2195,gene,1036952,1037309,gene,-1,357,crcBA
2196,CDS,1036952,1037309,CDS,-1,357,crcBB
2197,gene,1037305,1037701,gene,-1,396,crcBB
2198,CDS,1037305,1037701,CDS,-1,396,yhdW
2199,gene,1037687,1038419,gene,-1,732,yhdW
2200,CDS,1037687,1038419,CDS,-1,732,yhdX
2201,gene,1038652,1038760,gene,1,108,yhdX
2202,CDS,1038652,1038760,CDS,1,108,mscY
2203,gene,1038908,1040024,gene,1,1116,mscY
2204,CDS,1038908,1040024,CDS,1,1116,srtN
2205,gene,1040093,1040837,gene,1,744,srtN
2206,CDS,1040093,1040837,CDS,1,744,yheN
2207,gene,1040860,1041709,gene,-1,849,yheN
2208,CDS,1040860,1041709,CDS,-1,849,dat
2210,CDS,1041993,1042842,CDS,1,849,nhaC
2209,gene,1041993,1042842,gene,1,849,dat
2211,gene,1042884,1044246,gene,-1,1362,nhaC
2212,CDS,1042884,1044246,CDS,-1,1362,nhaX
2213,gene,1044372,1044873,gene,-1,501,nhaX
2214,CDS,1044372,1044873,CDS,-1,501,bmrB
2215,gene,1045036,1045198,gene,1,162,bmrB
2216,CDS,1045036,1045198,CDS,1,162,bmrC
2218,CDS,1045317,1047075,CDS,1,1758,bmrD
2217,gene,1045317,1047075,gene,1,1758,bmrC
2219,gene,1047071,1049093,gene,1,2022,bmrD
2220,CDS,1047071,1049093,CDS,1,2022,yheG
2221,gene,1049141,1049762,gene,-1,621,yheG
2222,CDS,1049141,1049762,CDS,-1,621,yheF
2223,gene,1049800,1049926,gene,-1,126,yheF
2224,CDS,1049800,1049926,CDS,-1,126,sspB
2225,gene,1050030,1050234,gene,-1,204,sspB
2226,CDS,1050030,1050234,CDS,-1,204,yheE
2228,CDS,1050442,1050661,CDS,-1,219,spaD
2227,gene,1050442,1050661,gene,-1,219,yheE
2229,gene,1050810,1052172,gene,-1,1362,spaD
2230,CDS,1050810,1052172,CDS,-1,1362,spaC
2231,gene,1052161,1053253,gene,-1,1092,spaC
2232,CDS,1052161,1053253,CDS,-1,1092,yheB
2233,gene,1053519,1054653,gene,1,1134,yheB
2234,CDS,1053519,1054653,CDS,1,1134,yheA
2236,CDS,1054745,1055099,CDS,1,354,yhaZ
2235,gene,1054745,1055099,gene,1,354,yheA
2237,gene,1055142,1056216,gene,-1,1074,yhaZ
2238,CDS,1055142,1056216,CDS,-1,1074,yhaX
2239,gene,1056701,1057568,gene,1,867,yhaX
2240,CDS,1056701,1057568,CDS,1,867,hemZ
2241,gene,1057679,1059185,gene,1,1506,hemZ
2242,CDS,1057679,1059185,CDS,1,1506,khtU
2243,gene,1059202,1060420,gene,-1,1218,khtU
2244,CDS,1059202,1060420,CDS,-1,1218,khtT
2246,CDS,1060426,1060924,CDS,-1,498,khtS
2245,gene,1060426,1060924,gene,-1,498,khtT
2247,gene,1060987,1061326,gene,-1,339,khtS
2248,CDS,1060987,1061326,CDS,-1,339,yhaR
2249,gene,1061490,1062258,gene,1,768,yhaR
2250,CDS,1061490,1062258,CDS,1,768,yhzD
2251,gene,1062278,1062464,gene,-1,186,yhzD
2252,CDS,1062278,1062464,CDS,-1,186,yhaQ
2253,gene,1062590,1063487,gene,1,897,yhaQ
2254,CDS,1062590,1063487,CDS,1,897,yhaP
2255,gene,1063479,1064739,gene,1,1260,yhaP
2256,CDS,1063479,1064739,CDS,1,1260,yhaO
2257,gene,1064845,1066072,gene,1,1227,yhaO
2258,CDS,1064845,1066072,CDS,1,1227,sbcE
2259,gene,1066076,1068968,gene,1,2892,sbcE
2260,CDS,1066076,1068968,CDS,1,2892,yhaM
2261,gene,1069041,1069986,gene,1,945,yhaM
2262,CDS,1069041,1069986,CDS,1,945,yhaL
2263,gene,1070110,1070323,gene,1,213,yhaL
2264,CDS,1070110,1070323,CDS,1,213,prsA
2265,gene,1070363,1071242,gene,-1,879,prsA
2266,CDS,1070363,1071242,CDS,-1,879,sscA
2268,CDS,1071401,1071488,CDS,1,87,sscB
2267,gene,1071401,1071488,gene,1,87,sscA
2269,gene,1071612,1071699,gene,1,87,sscB
2270,CDS,1071612,1071699,CDS,1,87,yhaJ
2271,gene,1072041,1072560,gene,-1,519,yhaJ
2272,CDS,1072041,1072560,CDS,-1,519,yhaI
2273,gene,1072767,1073109,gene,1,342,yhaI
2274,CDS,1072767,1073109,CDS,1,342,scoC
2275,gene,1073105,1073717,gene,-1,612,scoC
2276,CDS,1073105,1073717,CDS,-1,612,yhaH
2277,gene,1073894,1074251,gene,-1,357,yhaH
2278,CDS,1073894,1074251,CDS,-1,357,yhzF
2279,gene,1074380,1074572,gene,1,192,yhzF
2280,CDS,1074380,1074572,CDS,1,192,trpP
2281,gene,1074645,1075164,gene,-1,519,trpP
2282,CDS,1074645,1075164,CDS,-1,519,serC
2284,CDS,1075288,1076368,CDS,-1,1080,hinT
2283,gene,1075288,1076368,gene,-1,1080,serC
2285,gene,1076514,1076952,gene,-1,438,hinT
2286,CDS,1076514,1076952,CDS,-1,438,ecsA
2287,gene,1077439,1078183,gene,1,744,ecsA
2288,CDS,1077439,1078183,CDS,1,744,ecsB
2289,gene,1078175,1079402,gene,1,1227,ecsB
2290,CDS,1078175,1079402,CDS,1,1227,ecsC
2292,CDS,1079421,1080132,CDS,1,711,sndC
2291,gene,1079421,1080132,gene,1,711,ecsC
2293,gene,1080149,1081340,gene,-1,1191,sndC
2294,CDS,1080149,1081340,CDS,-1,1191,yhfA
2295,gene,1081412,1082804,gene,-1,1392,yhfA
2296,CDS,1081412,1082804,CDS,-1,1392,yhgB
2297,gene,1082869,1083184,gene,-1,315,yhgB
2298,CDS,1082869,1083184,CDS,-1,315,hmoB
2299,gene,1083228,1083729,gene,-1,501,hmoB
2300,CDS,1083228,1083729,CDS,-1,501,pbpF
2302,CDS,1083850,1085995,CDS,1,2145,hemE
2301,gene,1083850,1085995,gene,1,2145,pbpF
2303,gene,1086116,1087178,gene,1,1062,hemE
2304,CDS,1086116,1087178,CDS,1,1062,hemH
2305,gene,1087249,1088182,gene,1,933,hemH
2306,CDS,1087249,1088182,CDS,1,933,hemY
2307,gene,1088196,1089609,gene,1,1413,hemY
2308,CDS,1088196,1089609,CDS,1,1413,yhgD
2310,CDS,1089754,1090330,CDS,1,576,yhgE
2309,gene,1089754,1090330,gene,1,576,yhgD
2311,gene,1090400,1092728,gene,1,2328,yhgE
2312,CDS,1090400,1092728,CDS,1,2328,fabHB
2313,gene,1092769,1093747,gene,-1,978,fabHB
2314,CDS,1092769,1093747,CDS,-1,978,yhfC
2315,gene,1093873,1094650,gene,1,777,yhfC
2316,CDS,1093873,1094650,CDS,1,777,yhfE
2317,gene,1095062,1096103,gene,1,1041,yhfE
2318,CDS,1095062,1096103,CDS,1,1041,yhfF
2320,CDS,1096115,1096523,CDS,1,408,gltT
2319,gene,1096115,1096523,gene,1,408,yhfF
2321,gene,1096559,1097849,gene,-1,1290,gltT
2322,CDS,1096559,1097849,CDS,-1,1290,yhfH
2323,gene,1098119,1098260,gene,-1,141,yhfH
2324,CDS,1098119,1098260,CDS,-1,141,yhfI
2325,gene,1098411,1099146,gene,1,735,yhfI
2326,CDS,1098411,1099146,CDS,1,735,lplJ
2327,gene,1099158,1100154,gene,1,996,lplJ
2328,CDS,1099158,1100154,CDS,1,996,yhfK
2329,gene,1100218,1100863,gene,1,645,yhfK
2330,CDS,1100218,1100863,CDS,1,645,lcfB
2331,gene,1100979,1102521,gene,1,1542,lcfB
2332,CDS,1100979,1102521,CDS,1,1542,yhfM
2333,gene,1102559,1102955,gene,-1,396,yhfM
2334,CDS,1102559,1102955,CDS,-1,396,yhfN
2336,CDS,1103103,1104384,CDS,1,1281,aprE
2335,gene,1103103,1104384,gene,1,1281,yhfN
2338,CDS,1104422,1105568,CDS,-1,1146,yhfO
2337,gene,1104422,1105568,gene,-1,1146,aprE
2339,gene,1106002,1106452,gene,1,450,yhfO
2340,CDS,1106002,1106452,CDS,1,450,yhfP
2341,gene,1106523,1107516,gene,1,993,yhfP
2342,CDS,1106523,1107516,CDS,1,993,yhfQ
2343,gene,1107732,1108704,gene,1,972,yhfQ
2344,CDS,1107732,1108704,CDS,1,972,phoE
2345,gene,1108735,1109317,gene,-1,582,phoE
2346,CDS,1108735,1109317,CDS,-1,582,yhfS
2347,gene,1109387,1110482,gene,-1,1095,yhfS
2348,CDS,1109387,1110482,CDS,-1,1095,yhfT
2349,gene,1110478,1111918,gene,-1,1440,yhfT
2350,CDS,1110478,1111918,CDS,-1,1440,bioY
2351,gene,1111924,1112485,gene,-1,561,bioY
2352,CDS,1111924,1112485,CDS,-1,561,hemAT
2354,CDS,1112619,1113918,CDS,-1,1299,yhfW
2353,gene,1112619,1113918,gene,-1,1299,hemAT
2355,gene,1114056,1115586,gene,-1,1530,yhfW
2356,CDS,1114056,1115586,CDS,-1,1530,yhxC
2357,gene,1115697,1116555,gene,1,858,yhxC
2358,CDS,1115697,1116555,CDS,1,858,yhzC
2359,gene,1116582,1116816,gene,-1,234,yhzC
2360,CDS,1116582,1116816,CDS,-1,234,comK
2362,CDS,1117108,1117687,CDS,1,579,yhxD
2361,gene,1117108,1117687,gene,1,579,comK
2363,gene,1117733,1118633,gene,-1,900,yhxD
2364,CDS,1117733,1118633,CDS,-1,900,yhjA
2365,gene,1118849,1119119,gene,1,270,yhjA
2366,CDS,1118849,1119119,CDS,1,270,yhjB
2367,gene,1119161,1120631,gene,-1,1470,yhjB
2368,CDS,1119161,1120631,CDS,-1,1470,yhjC
2369,gene,1120627,1120828,gene,-1,201,yhjC
2370,CDS,1120627,1120828,CDS,-1,201,yhjD
2372,CDS,1121035,1121398,CDS,-1,363,yhjE
2371,gene,1121035,1121398,gene,-1,363,yhjD
2373,gene,1121549,1122173,gene,1,624,yhjE
2374,CDS,1121549,1122173,CDS,1,624,sipV
2375,gene,1122174,1122681,gene,1,507,sipV
2376,CDS,1122174,1122681,CDS,1,507,yhjG
2377,gene,1122861,1124361,gene,1,1500,yhjG
2378,CDS,1122861,1124361,CDS,1,1500,yhjH
2380,CDS,1124437,1124965,CDS,1,528,glcP
2379,gene,1124437,1124965,gene,1,528,yhjH
2381,gene,1125122,1126328,gene,-1,1206,glcP
2382,CDS,1125122,1126328,CDS,-1,1206,ntdC
2383,gene,1126399,1127452,gene,-1,1053,ntdC
2384,CDS,1126399,1127452,CDS,-1,1053,ntdB
2385,gene,1127465,1128314,gene,-1,849,ntdB
2386,CDS,1127465,1128314,CDS,-1,849,ntdA
2387,gene,1128285,1129611,gene,-1,1326,ntdA
2388,CDS,1128285,1129611,CDS,-1,1326,ntdR
2390,CDS,1129714,1130704,CDS,1,990,yhjN
2389,gene,1129714,1130704,gene,1,990,ntdR
2391,gene,1130917,1132072,gene,-1,1155,yhjN
2392,CDS,1130917,1132072,CDS,-1,1155,yhjO
2393,gene,1132178,1133384,gene,-1,1206,yhjO
2394,CDS,1132178,1133384,CDS,-1,1206,yhjP
2395,gene,1133497,1135225,gene,1,1728,yhjP
2396,CDS,1133497,1135225,CDS,1,1728,yhjQ
2397,gene,1135254,1135581,gene,-1,327,yhjQ
2398,CDS,1135254,1135581,CDS,-1,327,yhjR
2399,gene,1135698,1136136,gene,-1,438,yhjR
2400,CDS,1135698,1136136,CDS,-1,438,addB
2401,gene,1136319,1139820,gene,1,3501,addB
2402,CDS,1136319,1139820,CDS,1,3501,addA
2403,gene,1139806,1143505,gene,1,3699,addA
2404,CDS,1139806,1143505,CDS,1,3699,sbcD
2405,gene,1143576,1144752,gene,1,1176,sbcD
2406,CDS,1143576,1144752,CDS,1,1176,sbcC
2408,CDS,1144748,1148141,CDS,1,3393,hlpB
2407,gene,1144748,1148141,gene,1,3393,sbcC
2409,gene,1148154,1148457,gene,1,303,hlpB
2410,CDS,1148154,1148457,CDS,1,303,gerPF
2411,gene,1148493,1148712,gene,-1,219,gerPF
2412,CDS,1148493,1148712,CDS,-1,219,gerPE
2413,gene,1148743,1149145,gene,-1,402,gerPE
2414,CDS,1148743,1149145,CDS,-1,402,gerPD
2415,gene,1149144,1149321,gene,-1,177,gerPD
2416,CDS,1149144,1149321,CDS,-1,177,gerPC
2417,gene,1149317,1149935,gene,-1,618,gerPC
2418,CDS,1149317,1149935,CDS,-1,618,gerPB
2419,gene,1149957,1150191,gene,-1,234,gerPB
2420,CDS,1149957,1150191,CDS,-1,234,gerPA
2421,gene,1150205,1150427,gene,-1,222,gerPA
2422,CDS,1150205,1150427,CDS,-1,222,pchI
2424,CDS,1150849,1151020,CDS,-1,171,yisJ
2423,gene,1150849,1151020,gene,-1,171,pchI
2425,gene,1151165,1152089,gene,-1,924,yisJ
2426,CDS,1151165,1152089,CDS,-1,924,mblK
2427,gene,1152243,1153149,gene,1,906,mblK
2428,CDS,1152243,1153149,CDS,1,906,yisL
2429,gene,1153264,1153621,gene,1,357,yisL
2430,CDS,1153264,1153621,CDS,1,357,wprA
2432,CDS,1153788,1156473,CDS,1,2685,yisN
2431,gene,1153788,1156473,gene,1,2685,wprA
2433,gene,1156503,1157091,gene,-1,588,yisN
2434,CDS,1156503,1157091,CDS,-1,588,asnO
2435,gene,1157236,1159081,gene,1,1845,asnO
2436,CDS,1157236,1159081,CDS,1,1845,yizA
2437,gene,1159210,1159690,gene,-1,480,yizA
2438,CDS,1159210,1159690,CDS,-1,480,farP
2439,gene,1159921,1160746,gene,1,825,farP
2440,CDS,1159921,1160746,CDS,1,825,yisQ
2442,CDS,1160775,1162143,CDS,-1,1368,yisR
2441,gene,1160775,1162143,gene,-1,1368,yisQ
2443,gene,1162266,1163130,gene,1,864,yisR
2444,CDS,1162266,1163130,CDS,1,864,iolQ
2445,gene,1163147,1164161,gene,1,1014,iolQ
2446,CDS,1163147,1164161,CDS,1,1014,iolX
2447,gene,1164369,1165398,gene,1,1029,iolX
2448,CDS,1164369,1165398,CDS,1,1029,yisT
2450,CDS,1165448,1165958,CDS,-1,510,yisU
2449,gene,1165448,1165958,gene,-1,510,yisT
2451,gene,1166007,1166670,gene,-1,663,yisU
2452,CDS,1166007,1166670,CDS,-1,663,yisV
2453,gene,1166736,1168191,gene,1,1455,yisV
2454,CDS,1166736,1168191,CDS,1,1455,yisX
2455,gene,1168198,1168837,gene,-1,639,yisX
2456,CDS,1168198,1168837,CDS,-1,639,yisY
2457,gene,1169042,1169849,gene,1,807,yisY
2458,CDS,1169042,1169849,CDS,1,807,yisZ
2460,CDS,1169876,1170476,CDS,-1,600,yitA
2459,gene,1169876,1170476,gene,-1,600,yisZ
2461,gene,1170472,1171642,gene,-1,1170,yitA
2462,CDS,1170472,1171642,CDS,-1,1170,yitB
2463,gene,1171754,1172465,gene,-1,711,yitB
2464,CDS,1171754,1172465,CDS,-1,711,slpH
2465,gene,1172649,1173336,gene,1,687,slpH
2466,CDS,1172649,1173336,CDS,1,687,slpS
2467,gene,1173332,1174091,gene,1,759,slpS
2468,CDS,1173332,1174091,CDS,1,759,yitE
2469,gene,1174135,1174765,gene,-1,630,yitE
2470,CDS,1174135,1174765,CDS,-1,630,yitF
2471,gene,1174860,1175976,gene,-1,1116,yitF
2472,CDS,1174860,1175976,CDS,-1,1116,yitG
2473,gene,1175984,1177253,gene,-1,1269,yitG
2474,CDS,1175984,1177253,CDS,-1,1269,yitH
2476,CDS,1177364,1178213,CDS,-1,849,yitI
2475,gene,1177364,1178213,gene,-1,849,yitH
2478,CDS,1178217,1178667,CDS,-1,450,samT
2477,gene,1178217,1178667,gene,-1,450,yitI
2479,gene,1178756,1180595,gene,-1,1839,samT
2480,CDS,1178756,1180595,CDS,-1,1839,mswK
2481,gene,1180684,1180802,gene,-1,118,mswK
2482,misc_RNA,1180684,1180802,else,-1,118,yitK
2483,gene,1180908,1181400,gene,-1,492,yitK
2484,CDS,1180908,1181400,CDS,-1,492,yitL
2485,gene,1181498,1182395,gene,1,897,yitL
2486,CDS,1181498,1182395,CDS,1,897,yitM
2487,gene,1182447,1183032,gene,-1,585,yitM
2488,CDS,1182447,1183032,CDS,-1,585,yitO
2489,gene,1183028,1183958,gene,-1,930,yitO
2490,CDS,1183028,1183958,CDS,-1,930,yitP
2491,gene,1183942,1184479,gene,-1,537,yitP
2492,CDS,1183942,1184479,CDS,-1,537,yizB
2494,CDS,1184656,1185004,CDS,1,348,yitQ
2493,gene,1184656,1185004,gene,1,348,yizB
2495,gene,1185000,1185588,gene,1,588,yitQ
2496,CDS,1185000,1185588,CDS,1,588,yitR
2497,gene,1185607,1185901,gene,1,294,yitR
2498,CDS,1185607,1185901,CDS,1,294,nprB
2499,gene,1186036,1187653,gene,1,1617,nprB
2500,CDS,1186036,1187653,CDS,1,1617,fakBB
2502,CDS,1187699,1188551,CDS,-1,852,yitT
2501,gene,1187699,1188551,gene,-1,852,fakBB
2503,gene,1188688,1189531,gene,1,843,yitT
2504,CDS,1188688,1189531,CDS,1,843,ipi
2505,gene,1189645,1190005,gene,1,360,ipi
2506,CDS,1189645,1190005,CDS,1,360,yizC
2507,gene,1190035,1190233,gene,-1,198,yizC
2508,CDS,1190035,1190233,CDS,-1,198,ribZC
2509,gene,1190489,1191302,gene,-1,813,ribZC
2510,CDS,1190489,1191302,CDS,-1,813,yitV
2512,CDS,1191422,1192190,CDS,1,768,yitW
2511,gene,1191422,1192190,gene,1,768,yitV
2513,gene,1192253,1192562,gene,1,309,yitW
2514,CDS,1192253,1192562,CDS,1,309,yitY
2515,gene,1192857,1194288,gene,1,1431,yitY
2516,CDS,1192857,1194288,CDS,1,1431,yitZ
2517,gene,1194332,1194827,gene,1,495,yitZ
2518,CDS,1194332,1194827,CDS,1,495,argC
2520,CDS,1195033,1196071,CDS,1,1038,argJ
2519,gene,1195033,1196071,gene,1,1038,argC
2521,gene,1196090,1197311,gene,1,1221,argJ
2522,CDS,1196090,1197311,CDS,1,1221,argB
2523,gene,1197325,1198102,gene,1,777,argB
2524,CDS,1197325,1198102,CDS,1,777,argD
2525,gene,1198098,1199256,gene,1,1158,argD
2526,CDS,1198098,1199256,CDS,1,1158,carA
2527,gene,1199326,1200388,gene,1,1062,carA
2528,CDS,1199326,1200388,CDS,1,1062,carB
2530,CDS,1200380,1203473,CDS,1,3093,argF
2529,gene,1200380,1203473,gene,1,3093,carB
2531,gene,1203460,1204420,gene,1,960,argF
2532,CDS,1203460,1204420,CDS,1,960,yjzC
2533,gene,1204505,1204685,gene,1,180,yjzC
2534,CDS,1204505,1204685,CDS,1,180,yjzD
2535,gene,1204730,1204916,gene,-1,186,yjzD
2536,CDS,1204730,1204916,CDS,-1,186,yjaU
2537,gene,1205164,1205899,gene,1,735,yjaU
2538,CDS,1205164,1205899,CDS,1,735,yjaV
2539,gene,1205980,1206538,gene,1,558,yjaV
2540,CDS,1205980,1206538,CDS,1,558,med
2541,gene,1206628,1207582,gene,1,954,med
2542,CDS,1206628,1207582,CDS,1,954,comZ
2543,gene,1207596,1207788,gene,1,192,comZ
2544,CDS,1207596,1207788,CDS,1,192,yjzB
2545,gene,1207817,1208057,gene,-1,240,yjzB
2546,CDS,1207817,1208057,CDS,-1,240,fabHA
2547,gene,1208221,1209160,gene,1,939,fabHA
2548,CDS,1208221,1209160,CDS,1,939,fabF
2550,CDS,1209182,1210424,CDS,1,1242,yjaZ
2549,gene,1209182,1210424,gene,1,1242,fabF
2551,gene,1210499,1211285,gene,1,786,yjaZ
2552,CDS,1210499,1211285,CDS,1,786,appD
2553,gene,1211476,1212463,gene,1,987,appD
2554,CDS,1211476,1212463,CDS,1,987,appF
2555,gene,1212459,1213449,gene,1,990,appF
2556,CDS,1212459,1213449,CDS,1,990,appAn
2557,gene,1213536,1214001,gene,1,465,appAn
2558,misc_feature,1213536,1214001,else,1,465,appAc
2559,gene,1214000,1215167,gene,1,1167,appAc
2560,misc_feature,1214000,1215167,else,1,1167,appB
2561,gene,1215242,1216193,gene,1,951,appB
2562,CDS,1215242,1216193,CDS,1,951,appC
2563,gene,1216209,1217121,gene,1,912,appC
2564,CDS,1216209,1217121,CDS,1,912,yjbA
2566,CDS,1217325,1218078,CDS,1,753,trpS
2565,gene,1217325,1218078,gene,1,753,yjbA
2567,gene,1218112,1219105,gene,-1,993,trpS
2568,CDS,1218112,1219105,CDS,-1,993,tboWA
2569,gene,1219163,1219378,gene,-1,215,tboWA
2570,misc_RNA,1219163,1219378,else,-1,215,oppA
2571,gene,1219848,1221486,gene,1,1638,oppA
2572,CDS,1219848,1221486,CDS,1,1638,oppB
2574,CDS,1221593,1222529,CDS,1,936,oppC
2573,gene,1221593,1222529,gene,1,936,oppB
2575,gene,1222532,1223450,gene,1,918,oppC
2576,CDS,1222532,1223450,CDS,1,918,oppD
2577,gene,1223454,1224531,gene,1,1077,oppD
2578,CDS,1223454,1224531,CDS,1,1077,oppF
2579,gene,1224532,1225450,gene,1,918,oppF
2580,CDS,1224532,1225450,CDS,1,918,yjbB
2581,gene,1225556,1226774,gene,1,1218,yjbB
2582,CDS,1225556,1226774,CDS,1,1218,yjbC
2584,CDS,1226937,1227516,CDS,1,579,spxA
2583,gene,1226937,1227516,gene,1,579,yjbC
2585,gene,1227696,1228092,gene,1,396,spxA
2586,CDS,1227696,1228092,CDS,1,396,yjbE
2587,gene,1228134,1228791,gene,-1,657,yjbE
2588,CDS,1228134,1228791,CDS,-1,657,BSU_11515
2589,gene,1228960,1229101,gene,1,141,BSU_11515
2590,CDS,1228960,1229101,CDS,1,141,mecA
2592,CDS,1229067,1229724,CDS,1,657,BSU_11525
2591,gene,1229067,1229724,gene,1,657,mecA
2593,gene,1229718,1229841,gene,-1,123,BSU_11525
2594,CDS,1229718,1229841,CDS,-1,123,coiA
2595,gene,1229914,1231036,gene,1,1122,coiA
2596,CDS,1229914,1231036,CDS,1,1122,pepF
2597,gene,1231082,1233095,gene,1,2013,pepF
2598,CDS,1231082,1233095,CDS,1,2013,yizD
2599,gene,1233132,1233300,gene,-1,168,yizD
2600,CDS,1233132,1233300,CDS,-1,168,roxS
2602,misc_RNA,1233404,1233543,else,1,139,spxH
2601,gene,1233404,1233543,gene,1,139,roxS
2603,gene,1233613,1234513,gene,-1,900,spxH
2604,CDS,1233613,1234513,CDS,-1,900,yjbI
2605,gene,1234509,1234908,gene,-1,399,yjbI
2606,CDS,1234509,1234908,CDS,-1,399,cwlQ
2607,gene,1235162,1235708,gene,-1,546,cwlQ
2608,CDS,1235162,1235708,CDS,-1,546,yjbK
2609,gene,1235911,1236484,gene,-1,573,yjbK
2610,CDS,1235911,1236484,CDS,-1,573,yjbL
2611,gene,1236608,1236977,gene,1,369,yjbL
2612,CDS,1236608,1236977,CDS,1,369,relP
2613,gene,1237005,1237641,gene,1,636,relP
2614,CDS,1237005,1237641,CDS,1,636,ppnKA
2615,gene,1237659,1238460,gene,1,801,ppnKA
2616,CDS,1237659,1238460,CDS,1,801,yjbO
2617,gene,1238522,1239374,gene,1,852,yjbO
2618,CDS,1238522,1239374,CDS,1,852,prpE
2620,CDS,1239386,1240121,CDS,-1,735,kefQ
2619,gene,1239386,1240121,gene,-1,735,prpE
2621,gene,1240355,1242200,gene,1,1845,kefQ
2622,CDS,1240355,1242200,CDS,1,1845,tswA
2623,gene,1242261,1242370,gene,1,109,tswA
2624,misc_RNA,1242261,1242370,else,1,109,tenA
2625,gene,1242448,1243159,gene,1,711,tenA
2626,CDS,1242448,1243159,CDS,1,711,tenI
2628,CDS,1243133,1243751,CDS,1,618,thiO
2627,gene,1243133,1243751,gene,1,618,tenI
2629,gene,1243734,1244844,gene,1,1110,thiO
2630,CDS,1243734,1244844,CDS,1,1110,thiS
2631,gene,1244843,1245044,gene,1,201,thiS
2632,CDS,1244843,1245044,CDS,1,201,thiG
2633,gene,1245040,1245811,gene,1,771,thiG
2634,CDS,1245040,1245811,CDS,1,771,thiF
2636,CDS,1245807,1246818,CDS,1,1011,thiD
2635,gene,1245807,1246818,gene,1,1011,thiF
2638,CDS,1246836,1247652,CDS,1,816,fabI
2637,gene,1246836,1247652,gene,1,816,thiD
2639,gene,1247787,1248564,gene,1,777,fabI
2640,CDS,1247787,1248564,CDS,1,777,cotO
2641,gene,1248664,1249348,gene,1,684,cotO
2642,CDS,1248664,1249348,CDS,1,684,cotZ
2643,gene,1249441,1249888,gene,-1,447,cotZ
2644,CDS,1249441,1249888,CDS,-1,447,cotY
2645,gene,1250015,1250504,gene,-1,489,cotY
2646,CDS,1250015,1250504,CDS,-1,489,cotX
2648,CDS,1250655,1251174,CDS,-1,519,cotW
2647,gene,1250655,1251174,gene,-1,519,cotX
2649,gene,1251272,1251590,gene,-1,318,cotW
2650,CDS,1251272,1251590,CDS,-1,318,cotV
2651,gene,1251630,1252017,gene,-1,387,cotV
2652,CDS,1251630,1252017,CDS,-1,387,yjcA
2653,gene,1252176,1252533,gene,1,357,yjcA
2654,CDS,1252176,1252533,CDS,1,357,BSU_11798
2656,misc_feature,1252557,1252791,else,-1,234,yjzK
2655,gene,1252557,1252791,gene,-1,234,BSU_11798
2657,gene,1252814,1253021,gene,1,207,yjzK
2658,CDS,1252814,1253021,CDS,1,207,yjcB
2659,gene,1252857,1253073,gene,1,216,yjcB
2660,CDS,1252857,1253073,CDS,1,216,yjcZ
2661,gene,1253102,1253252,gene,1,150,yjcZ
2662,CDS,1253102,1253252,CDS,1,150,spoVIF
2663,gene,1253384,1253639,gene,1,255,spoVIF
2664,CDS,1253384,1253639,CDS,1,255,yjcD
2665,gene,1253712,1255992,gene,-1,2280,yjcD
2666,CDS,1253712,1255992,CDS,-1,2280,yjzE
2667,gene,1256108,1256363,gene,1,255,yjzE
2668,CDS,1256108,1256363,CDS,1,255,yjcF
2669,gene,1256435,1256858,gene,-1,423,yjcF
2670,CDS,1256435,1256858,CDS,-1,423,yjcG
2672,CDS,1256861,1257377,CDS,-1,516,yjcH
2671,gene,1256861,1257377,gene,-1,516,yjcG
2673,gene,1257413,1258136,gene,-1,723,yjcH
2674,CDS,1257413,1258136,CDS,-1,723,mswA
2675,gene,1258303,1258424,gene,1,121,mswA
2676,misc_RNA,1258303,1258424,else,1,121,metI
2677,gene,1258491,1259613,gene,1,1122,metI
2678,CDS,1258491,1259613,CDS,1,1122,metC
2680,CDS,1259605,1260778,CDS,1,1173,yjcK
2679,gene,1259605,1260778,gene,1,1173,metC
2681,gene,1260810,1261356,gene,-1,546,yjcK
2682,CDS,1260810,1261356,CDS,-1,546,yjcL
2683,gene,1261425,1262616,gene,-1,1191,yjcL
2684,CDS,1261425,1262616,CDS,-1,1191,trnSL-Val2
2685,gene,1262788,1262861,gene,1,73,trnSL-Val2
2686,tRNA,1262788,1262861,else,1,73,yjcM
2687,gene,1263701,1264931,gene,-1,1230,yjcM
2688,CDS,1263701,1264931,CDS,-1,1230,yjcN
2690,CDS,1265056,1265377,CDS,1,321,yjzF
2689,gene,1265056,1265377,gene,1,321,yjcN
2692,CDS,1265529,1265661,CDS,1,132,yjzG
2691,gene,1265529,1265661,gene,1,132,yjzF
2693,gene,1265676,1265850,gene,1,174,yjzG
2694,CDS,1265676,1265850,CDS,1,174,yjcO
2695,gene,1265886,1266348,gene,1,462,yjcO
2696,CDS,1265886,1266348,CDS,1,462,yjcP
2697,gene,1266613,1267117,gene,1,504,yjcP
2698,CDS,1266613,1267117,CDS,1,504,yjcQ
2699,gene,1267128,1267413,gene,1,285,yjcQ
2700,CDS,1267128,1267413,CDS,1,285,yjcR
2701,gene,1267573,1268101,gene,1,528,yjcR
2702,CDS,1267573,1268101,CDS,1,528,yjcS
2703,gene,1268274,1268592,gene,1,318,yjcS
2704,CDS,1268274,1268592,CDS,1,318,yjdA
2705,gene,1268828,1269584,gene,1,756,yjdA
2706,CDS,1268828,1269584,CDS,1,756,yjdB
2707,gene,1269732,1270080,gene,-1,348,yjdB
2708,CDS,1269732,1270080,CDS,-1,348,manR
2710,CDS,1270630,1272577,CDS,1,1947,manP
2709,gene,1270630,1272577,gene,1,1947,manR
2711,gene,1272724,1274677,gene,1,1953,manP
2712,CDS,1272724,1274677,CDS,1,1953,manA
2713,gene,1274691,1275639,gene,1,948,manA
2714,CDS,1274691,1275639,CDS,1,948,yjdF
2715,gene,1275808,1276291,gene,1,483,yjdF
2716,CDS,1275808,1276291,CDS,1,483,yjdG
2718,CDS,1276336,1276843,CDS,-1,507,yjdH
2717,gene,1276336,1276843,gene,-1,507,yjdG
2719,gene,1277061,1277457,gene,-1,396,yjdH
2720,CDS,1277061,1277457,CDS,-1,396,trnE
2721,gene,1277685,1278165,gene,1,480,trnE
2722,CDS,1277685,1278165,CDS,1,480,yjzH
2723,gene,1278204,1278399,gene,-1,195,yjzH
2724,CDS,1278204,1278399,CDS,-1,195,yjdJ
2726,CDS,1278564,1278894,CDS,-1,330,ctaO
2725,gene,1278564,1278894,gene,-1,330,yjdJ
2728,CDS,1279513,1280503,CDS,-1,990,cotT
2727,gene,1279513,1280503,gene,-1,990,ctaO
2729,gene,1280625,1280874,gene,-1,249,cotT
2730,CDS,1280625,1280874,CDS,-1,249,pdaC
2731,gene,1281127,1282531,gene,1,1404,pdaC
2732,CDS,1281127,1282531,CDS,1,1404,yjfA
2733,gene,1282570,1283044,gene,-1,474,yjfA
2734,CDS,1282570,1283044,CDS,-1,474,yjfB
2735,gene,1283168,1283336,gene,-1,168,yjfB
2736,CDS,1283168,1283336,CDS,-1,168,yjfC
2738,CDS,1283462,1284362,CDS,1,900,yjgA
2737,gene,1283462,1284362,gene,1,900,yjfC
2739,gene,1284370,1284769,gene,-1,399,yjgA
2740,CDS,1284370,1284769,CDS,-1,399,yjgB
2741,gene,1284869,1285445,gene,-1,576,yjgB
2742,CDS,1284869,1285445,CDS,-1,576,yjgC
2743,gene,1285590,1288548,gene,1,2958,yjgC
2744,CDS,1285590,1288548,CDS,1,2958,yjgD
2746,CDS,1288540,1289101,CDS,1,561,yjhA
2745,gene,1288540,1289101,gene,1,561,yjgD
2747,gene,1289297,1289939,gene,1,642,yjhA
2748,CDS,1289297,1289939,CDS,1,642,yjhB
2749,gene,1290017,1290644,gene,1,627,yjhB
2750,CDS,1290017,1290644,CDS,1,627,yjiA
2751,gene,1290674,1290953,gene,-1,279,yjiA
2752,CDS,1290674,1290953,CDS,-1,279,cypE
2753,gene,1291343,1292534,gene,1,1191,cypE
2754,CDS,1291343,1292534,CDS,1,1191,ppuG
2755,gene,1292556,1293735,gene,1,1179,ppuG
2756,CDS,1292556,1293735,CDS,1,1179,yjzI
2757,gene,1293775,1293964,gene,-1,189,yjzI
2758,CDS,1293775,1293964,CDS,-1,189,yjjA
2759,gene,1294137,1294950,gene,1,813,yjjA
2760,CDS,1294137,1294950,CDS,1,813,yjkA
2762,CDS,1294995,1295748,CDS,-1,753,yjkB
2761,gene,1294995,1295748,gene,-1,753,yjkA
2763,gene,1295747,1296500,gene,-1,753,yjkB
2764,CDS,1295747,1296500,CDS,-1,753,yjlA
2765,gene,1296619,1297594,gene,-1,975,yjlA
2766,CDS,1296619,1297594,CDS,-1,975,yjlB
2767,gene,1297725,1298223,gene,1,498,yjlB
2768,CDS,1297725,1298223,CDS,1,498,yjlC
2769,gene,1298611,1299034,gene,1,423,yjlC
2770,CDS,1298611,1299034,CDS,1,423,ndh
2771,gene,1299073,1300252,gene,1,1179,ndh
2772,CDS,1299073,1300252,CDS,1,1179,uxaC
2773,gene,1300449,1301871,gene,1,1422,uxaC
2774,CDS,1300449,1301871,CDS,1,1422,exuM
2775,gene,1301938,1303318,gene,1,1380,exuM
2776,CDS,1301938,1303318,CDS,1,1380,yjmC
2778,CDS,1303422,1304436,CDS,1,1014,yjmD
2777,gene,1303422,1304436,gene,1,1014,yjmC
2779,gene,1304441,1305461,gene,1,1020,yjmD
2780,CDS,1304441,1305461,CDS,1,1020,uxuA
2781,gene,1305485,1306565,gene,1,1080,uxuA
2782,CDS,1305485,1306565,CDS,1,1080,uxuB
2783,gene,1306561,1307398,gene,1,837,uxuB
2784,CDS,1306561,1307398,CDS,1,837,exuT
2786,CDS,1307445,1308714,CDS,1,1269,exuR
2785,gene,1307445,1308714,gene,1,1269,exuT
2787,gene,1308801,1309803,gene,1,1002,exuR
2788,CDS,1308801,1309803,CDS,1,1002,uxaB
2789,gene,1309879,1311322,gene,1,1443,uxaB
2790,CDS,1309879,1311322,CDS,1,1443,uxaA
2791,gene,1311318,1312812,gene,1,1494,uxaA
2792,CDS,1311318,1312812,CDS,1,1494,yjnA
2793,gene,1312850,1313615,gene,-1,765,yjnA
2794,CDS,1312850,1313615,CDS,-1,765,yjoA
2796,CDS,1313839,1314304,CDS,-1,465,yjoB
2795,gene,1313839,1314304,gene,-1,465,yjoA
2797,gene,1314452,1315724,gene,1,1272,yjoB
2798,CDS,1314452,1315724,CDS,1,1272,rapA
2799,gene,1315868,1317005,gene,1,1137,rapA
2800,CDS,1315868,1317005,CDS,1,1137,phrA
2801,gene,1316994,1317129,gene,1,135,phrA
2802,CDS,1316994,1317129,CDS,1,135,yjpA
2804,CDS,1317156,1317414,CDS,-1,258,xlyB
2803,gene,1317156,1317414,gene,-1,258,yjpA
2805,gene,1317534,1318488,gene,1,954,xlyB
2806,CDS,1317534,1318488,CDS,1,954,yjqA
2807,gene,1318527,1318905,gene,-1,378,yjqA
2808,CDS,1318527,1318905,CDS,-1,378,pghB
2809,gene,1319010,1319613,gene,1,603,pghB
2810,CDS,1319010,1319613,CDS,1,603,xpdC
2811,gene,1319689,1320526,gene,1,837,xpdC
2812,CDS,1319689,1320526,CDS,1,837,xkdA
2814,CDS,1320569,1321166,CDS,-1,597,xre
2813,gene,1320569,1321166,gene,-1,597,xkdA
2815,gene,1321328,1321670,gene,-1,342,xre
2816,CDS,1321328,1321670,CDS,-1,342,yjzJ
2817,gene,1321847,1322027,gene,1,180,yjzJ
2818,CDS,1321847,1322027,CDS,1,180,xkdB
2819,gene,1322013,1322850,gene,1,837,xkdB
2820,CDS,1322013,1322850,CDS,1,837,xkdC
2821,gene,1322749,1323550,gene,1,801,xkdC
2822,CDS,1322749,1323550,CDS,1,801,ykzK
2823,gene,1323549,1323717,gene,1,168,ykzK
2824,CDS,1323549,1323717,CDS,1,168,xkdD
2825,gene,1323801,1324152,gene,1,351,xkdD
2826,CDS,1323801,1324152,CDS,1,351,xtrA
2827,gene,1324148,1324355,gene,1,207,xtrA
2828,CDS,1324148,1324355,CDS,1,207,xpf
2829,gene,1324470,1324980,gene,1,510,xpf
2830,CDS,1324470,1324980,CDS,1,510,xtmA
2831,gene,1325095,1325893,gene,1,798,xtmA
2832,CDS,1325095,1325893,CDS,1,798,xtmB
2834,CDS,1325889,1327191,CDS,1,1302,xkdE
2833,gene,1325889,1327191,gene,1,1302,xtmB
2835,gene,1327194,1328682,gene,1,1488,xkdE
2836,CDS,1327194,1328682,CDS,1,1488,xkdF
2837,gene,1328701,1329529,gene,1,828,xkdF
2838,CDS,1328701,1329529,CDS,1,828,xkdG
2839,gene,1329554,1330490,gene,1,936,xkdG
2840,CDS,1329554,1330490,CDS,1,936,ykzL
2841,gene,1330511,1330895,gene,1,384,ykzL
2842,CDS,1330511,1330895,CDS,1,384,xkdH
2843,gene,1330891,1331248,gene,1,357,xkdH
2844,CDS,1330891,1331248,CDS,1,357,xkdI
2845,gene,1331244,1331730,gene,1,486,xkdI
2846,CDS,1331244,1331730,CDS,1,486,xkdJ
2847,gene,1331742,1332183,gene,1,441,xkdJ
2848,CDS,1331742,1332183,CDS,1,441,ykzM
2850,CDS,1332186,1332405,CDS,1,219,xkdK
2849,gene,1332186,1332405,gene,1,219,ykzM
2851,gene,1332401,1333802,gene,1,1401,xkdK
2852,CDS,1332401,1333802,CDS,1,1401,xkdM
2853,gene,1333803,1334247,gene,1,444,xkdM
2854,CDS,1333803,1334247,CDS,1,444,xkdN
2855,gene,1334338,1334785,gene,1,447,xkdN
2856,CDS,1334338,1334785,CDS,1,447,xkzB
2858,CDS,1334814,1334964,CDS,1,150,xkdO
2857,gene,1334814,1334964,gene,1,150,xkzB
2859,gene,1334965,1338964,gene,1,3999,xkdO
2860,CDS,1334965,1338964,CDS,1,3999,xkdP
2861,gene,1338956,1339616,gene,1,660,xkdP
2862,CDS,1338956,1339616,CDS,1,660,xkdQ
2863,gene,1339631,1340609,gene,1,978,xkdQ
2864,CDS,1339631,1340609,CDS,1,978,xkdR
2865,gene,1340608,1340875,gene,1,267,xkdR
2866,CDS,1340608,1340875,CDS,1,267,xkdS
2868,CDS,1340931,1341357,CDS,1,426,xkdT
2867,gene,1340931,1341357,gene,1,426,xkdS
2869,gene,1341349,1342396,gene,1,1047,xkdT
2870,CDS,1341349,1342396,CDS,1,1047,xkdU
2871,gene,1342379,1342958,gene,1,579,xkdU
2872,CDS,1342379,1342958,CDS,1,579,xkzA
2873,gene,1342954,1343227,gene,1,273,xkzA
2874,CDS,1342954,1343227,CDS,1,273,xkdV
2876,CDS,1343229,1345293,CDS,1,2064,xkdW
2875,gene,1343229,1345293,gene,1,2064,xkdV
2877,gene,1345304,1345634,gene,1,330,xkdW
2878,CDS,1345304,1345634,CDS,1,330,xkdX
2879,gene,1345630,1345795,gene,1,165,xkdX
2880,CDS,1345630,1345795,CDS,1,165,xepA
2881,gene,1345838,1346678,gene,1,840,xepA
2882,CDS,1345838,1346678,CDS,1,840,xhlA
2883,gene,1346730,1347000,gene,1,270,xhlA
2884,CDS,1346730,1347000,CDS,1,270,xhlB
2886,CDS,1347012,1347276,CDS,1,264,xlyA
2885,gene,1347012,1347276,gene,1,264,xhlB
2887,gene,1347288,1348182,gene,1,894,xlyA
2888,CDS,1347288,1348182,CDS,1,894,spoIISC
2889,gene,1348218,1348356,gene,-1,138,spoIISC
2890,CDS,1348218,1348356,CDS,-1,138,spoIISB
2891,gene,1348441,1348612,gene,-1,171,spoIISB
2892,CDS,1348441,1348612,CDS,-1,171,spoIISA
2893,gene,1348611,1349358,gene,-1,747,spoIISA
2894,CDS,1348611,1349358,CDS,-1,747,pitB
2895,gene,1349467,1350469,gene,-1,1002,pitB
2896,CDS,1349467,1350469,CDS,-1,1002,ykaA
2897,gene,1350481,1351099,gene,-1,618,ykaA
2898,CDS,1350481,1351099,CDS,-1,618,steT
2899,gene,1351374,1352691,gene,-1,1317,steT
2900,CDS,1351374,1352691,CDS,-1,1317,mhqA
2901,gene,1353079,1354030,gene,1,951,mhqA
2902,CDS,1353079,1354030,CDS,1,951,BSU_12875
2904,CDS,1354130,1354277,CDS,1,147,ykcB
2903,gene,1354130,1354277,gene,1,147,BSU_12875
2905,gene,1354284,1356435,gene,1,2151,ykcB
2906,CDS,1354284,1356435,CDS,1,2151,ykcC
2907,gene,1356446,1357418,gene,1,972,ykcC
2908,CDS,1356446,1357418,CDS,1,972,htrA
2909,gene,1357935,1359285,gene,-1,1350,htrA
2910,CDS,1357935,1359285,CDS,-1,1350,proCC
2912,CDS,1359453,1360272,CDS,1,819,dppA
2911,gene,1359453,1360272,gene,1,819,proCC
2913,gene,1360400,1361225,gene,1,825,dppA
2914,CDS,1360400,1361225,CDS,1,825,dppB
2915,gene,1361241,1362168,gene,1,927,dppB
2916,CDS,1361241,1362168,CDS,1,927,dppC
2917,gene,1362173,1363136,gene,1,963,dppC
2918,CDS,1362173,1363136,CDS,1,963,dppD
2920,CDS,1363140,1364148,CDS,1,1008,dppE
2919,gene,1363140,1364148,gene,1,1008,dppD
2922,CDS,1364150,1365800,CDS,1,1650,ldcA
2921,gene,1364150,1365800,gene,1,1650,dppE
2923,gene,1365887,1366847,gene,1,960,ldcA
2924,CDS,1365887,1366847,CDS,1,960,aeeB
2925,gene,1366843,1367944,gene,1,1101,aeeB
2926,CDS,1366843,1367944,CDS,1,1101,eepC
2927,gene,1367940,1368831,gene,1,891,eepC
2928,CDS,1367940,1368831,CDS,1,891,ykfD
2929,gene,1368843,1369833,gene,1,990,ykfD
2930,CDS,1368843,1369833,CDS,1,990,pgl
2932,CDS,1369875,1370925,CDS,-1,1050,ddaH
2931,gene,1369875,1370925,gene,-1,1050,pgl
2933,gene,1371014,1371875,gene,-1,861,ddaH
2934,CDS,1371014,1371875,CDS,-1,861,ykhA
2935,gene,1372034,1372553,gene,1,519,ykhA
2936,CDS,1372034,1372553,CDS,1,519,hmpA
2937,gene,1372791,1373991,gene,1,1200,hmpA
2938,CDS,1372791,1373991,CDS,1,1200,ykzH
2940,CDS,1374067,1374292,CDS,-1,225,ykjA
2939,gene,1374067,1374292,gene,-1,225,ykzH
2941,gene,1374436,1375168,gene,1,732,ykjA
2942,CDS,1374436,1375168,CDS,1,732,ykkA
2943,gene,1375259,1375787,gene,1,528,ykkA
2944,CDS,1375259,1375787,CDS,1,528,ykkB
2945,gene,1375776,1376295,gene,1,519,ykkB
2946,CDS,1375776,1376295,CDS,1,519,gdwA
2947,gene,1376327,1376439,gene,1,112,gdwA
2948,misc_RNA,1376327,1376439,else,1,112,gdnC
2949,gene,1376516,1376855,gene,1,339,gdnC
2950,CDS,1376516,1376855,CDS,1,339,gdnD
2951,gene,1376854,1377172,gene,1,318,gdnD
2952,CDS,1376854,1377172,CDS,1,318,purU
2953,gene,1377242,1378145,gene,1,903,purU
2954,CDS,1377242,1378145,CDS,1,903,pswB
2956,misc_RNA,1378232,1378443,else,1,211,proB
2955,gene,1378232,1378443,gene,1,211,pswB
2957,gene,1378495,1379593,gene,1,1098,proB
2958,CDS,1378495,1379593,CDS,1,1098,proA
2959,gene,1379604,1380852,gene,1,1248,proA
2960,CDS,1379604,1380852,CDS,1,1248,ohrA
2961,gene,1380977,1381403,gene,1,426,ohrA
2962,CDS,1380977,1381403,CDS,1,426,ohrR
2964,CDS,1381433,1381877,CDS,-1,444,ohrB
2963,gene,1381433,1381877,gene,-1,444,ohrR
2965,gene,1382019,1382430,gene,1,411,ohrB
2966,CDS,1382019,1382430,CDS,1,411,ykzN
2967,gene,1382456,1382627,gene,1,171,ykzN
2968,CDS,1382456,1382627,CDS,1,171,guaN
2969,gene,1382676,1383147,gene,-1,471,guaN
2970,CDS,1382676,1383147,CDS,-1,471,metE
2971,gene,1383319,1385608,gene,-1,2289,metE
2972,CDS,1383319,1385608,CDS,-1,2289,mswB
2974,misc_RNA,1385735,1385891,else,-1,156,ispA
2973,gene,1385735,1385891,gene,-1,156,mswB
2976,CDS,1386023,1386983,CDS,-1,960,rsbRB
2975,gene,1386023,1386983,gene,-1,960,ispA
2977,gene,1387205,1388039,gene,1,834,rsbRB
2978,CDS,1387205,1388039,CDS,1,834,thiX
2979,gene,1388069,1388834,gene,-1,765,thiX
2980,CDS,1388069,1388834,CDS,-1,765,thiW
2981,gene,1388808,1390452,gene,-1,1644,thiW
2982,CDS,1388808,1390452,CDS,-1,1644,thiV
2983,gene,1390438,1391038,gene,-1,600,thiV
2984,CDS,1390438,1391038,CDS,-1,600,thiU
2986,CDS,1391039,1391642,CDS,-1,603,tswB
2985,gene,1391039,1391642,gene,-1,603,thiU
2987,gene,1391738,1391851,gene,-1,113,tswB
2988,misc_RNA,1391738,1391851,else,-1,113,ykoG
2989,gene,1391952,1392639,gene,1,687,ykoG
2990,CDS,1391952,1392639,CDS,1,687,ykoH
2991,gene,1392642,1394007,gene,1,1365,ykoH
2992,CDS,1392642,1394007,CDS,1,1365,ykoI
2994,CDS,1394003,1394684,CDS,1,681,ykoJ
2993,gene,1394003,1394684,gene,1,681,ykoI
2995,gene,1394775,1395288,gene,1,513,ykoJ
2996,CDS,1394775,1395288,CDS,1,513,ykzD
2997,gene,1395370,1395508,gene,1,138,ykzD
2998,CDS,1395370,1395508,CDS,1,138,swmG
2999,gene,1395621,1395775,gene,1,154,swmG
3000,misc_RNA,1395621,1395775,else,1,154,mgtE
3001,gene,1396012,1397368,gene,1,1356,mgtE
3002,CDS,1396012,1397368,CDS,1,1356,tnrA
3003,gene,1397410,1397743,gene,-1,333,tnrA
3004,CDS,1397410,1397743,CDS,-1,333,ykzB
3005,gene,1397937,1398093,gene,1,156,ykzB
3006,CDS,1397937,1398093,CDS,1,156,ykoL
3007,gene,1398180,1398363,gene,1,183,ykoL
3008,CDS,1398180,1398363,CDS,1,183,ykoM
3009,gene,1398495,1398960,gene,1,465,ykoM
3010,CDS,1398495,1398960,CDS,1,465,ykoN
3012,CDS,1398974,1400096,CDS,-1,1122,ykoP
3011,gene,1398974,1400096,gene,-1,1122,ykoN
3013,gene,1400187,1400739,gene,1,552,ykoP
3014,CDS,1400187,1400739,CDS,1,552,ykoQ
3015,gene,1400766,1401579,gene,-1,813,ykoQ
3016,CDS,1400766,1401579,CDS,-1,813,ykoS
3017,gene,1401771,1403466,gene,1,1695,ykoS
3018,CDS,1401771,1403466,CDS,1,1695,ykoT
3020,CDS,1403478,1404492,CDS,1,1014,ligD
3019,gene,1403478,1404492,gene,1,1014,ykoT
3021,gene,1404517,1406353,gene,-1,1836,ligD
3022,CDS,1404517,1406353,CDS,-1,1836,ligV
3023,gene,1406356,1407292,gene,-1,936,ligV
3024,CDS,1406356,1407292,CDS,-1,936,dgcW
3025,gene,1407328,1409731,gene,-1,2403,dgcW
3026,CDS,1407328,1409731,CDS,-1,2403,ykoX
3027,gene,1409911,1410577,gene,1,666,ykoX
3028,CDS,1409911,1410577,CDS,1,666,mnrW
3030,misc_RNA,1410632,1410766,else,1,134,ykoY
3029,gene,1410632,1410766,gene,1,134,mnrW
3031,gene,1410653,1411628,gene,1,975,ykoY
3032,CDS,1410653,1411628,CDS,1,975,sigI
3033,gene,1411891,1412647,gene,1,756,sigI
3034,CDS,1411891,1412647,CDS,1,756,rsgI
3035,gene,1412643,1413789,gene,1,1146,rsgI
3036,CDS,1412643,1413789,CDS,1,1146,sspD
3037,gene,1413799,1413994,gene,-1,195,sspD
3038,CDS,1413799,1413994,CDS,-1,195,htpK
3039,gene,1414124,1414826,gene,-1,702,htpK
3040,CDS,1414124,1414826,CDS,-1,702,htpX
3041,gene,1414996,1415893,gene,1,897,htpX
3042,CDS,1414996,1415893,CDS,1,897,ktrD
3043,gene,1416066,1417416,gene,1,1350,ktrD
3044,CDS,1416066,1417416,CDS,1,1350,ykzP
3046,CDS,1417560,1417716,CDS,1,156,ykzE
3045,gene,1417560,1417716,gene,1,156,ykzP
3048,CDS,1417718,1417895,CDS,1,177,ykrP
3047,gene,1417718,1417895,gene,1,177,ykzE
3049,gene,1417937,1418960,gene,-1,1023,ykrP
3050,CDS,1417937,1418960,CDS,-1,1023,kinE
3051,gene,1419212,1421429,gene,1,2217,kinE
3052,CDS,1419212,1421429,CDS,1,2217,ogt
3053,gene,1421425,1421923,gene,1,498,ogt
3054,CDS,1421425,1421923,CDS,1,498,BSU_13545
3055,gene,1422012,1422138,gene,1,126,BSU_13545
3056,CDS,1422012,1422138,CDS,1,126,mtnA
3057,gene,1422171,1423233,gene,-1,1062,mtnA
3058,CDS,1422171,1423233,CDS,-1,1062,mtnK
3059,gene,1423240,1424434,gene,-1,1194,mtnK
3060,CDS,1423240,1424434,CDS,-1,1194,mswC
3061,gene,1424526,1424683,gene,-1,157,mswC
3062,misc_RNA,1424526,1424683,else,-1,157,mtnU
3063,gene,1424766,1425546,gene,-1,780,mtnU
3064,CDS,1424766,1425546,CDS,-1,780,mtnE
3066,CDS,1425640,1426837,CDS,1,1197,mswD
3065,gene,1425640,1426837,gene,1,1197,mtnE
3067,gene,1426875,1426976,gene,1,101,mswD
3068,misc_RNA,1426875,1426976,else,1,101,mtnW
3069,gene,1427060,1428278,gene,1,1218,mtnW
3070,CDS,1427060,1428278,CDS,1,1218,mtnX
3071,gene,1428274,1428982,gene,1,708,mtnX
3072,CDS,1428274,1428982,CDS,1,708,mtnB
3074,CDS,1428939,1429569,CDS,1,630,mtnD
3073,gene,1428939,1429569,gene,1,630,mtnB
3075,gene,1429583,1430120,gene,1,537,mtnD
3076,CDS,1429583,1430120,CDS,1,537,ykvA
3077,gene,1430160,1430481,gene,-1,321,ykvA
3078,CDS,1430160,1430481,CDS,-1,321,spo0E
3079,gene,1430683,1430941,gene,1,258,spo0E
3080,CDS,1430683,1430941,CDS,1,258,eag
3082,CDS,1431026,1431458,CDS,1,432,kinD
3081,gene,1431026,1431458,gene,1,432,eag
3084,CDS,1431485,1433006,CDS,-1,1521,mhqR
3083,gene,1431485,1433006,gene,-1,1521,kinD
3085,gene,1433198,1433636,gene,1,438,mhqR
3086,CDS,1433198,1433636,CDS,1,438,motB
3087,gene,1433675,1434461,gene,-1,786,motB
3088,CDS,1433675,1434461,CDS,-1,786,motA
3089,gene,1434432,1435245,gene,-1,813,motA
3090,CDS,1434432,1435245,CDS,-1,813,clpE
3091,gene,1435627,1437727,gene,-1,2100,clpE
3092,CDS,1435627,1437727,CDS,-1,2100,ykvI
3094,CDS,1438091,1439135,CDS,1,1044,qswA
3093,gene,1438091,1439135,gene,1,1044,ykvI
3095,gene,1439273,1439318,gene,1,45,qswA
3096,misc_RNA,1439273,1439318,else,1,45,queC
3097,gene,1439447,1440107,gene,1,660,queC
3098,CDS,1439447,1440107,CDS,1,660,queD
3099,gene,1440099,1440549,gene,1,450,queD
3100,CDS,1440099,1440549,CDS,1,450,queE
3102,CDS,1440541,1441273,CDS,1,732,queF
3101,gene,1440541,1441273,gene,1,732,queE
3103,gene,1441290,1441788,gene,1,498,queF
3104,CDS,1441290,1441788,CDS,1,498,ykvN
3105,gene,1442346,1442703,gene,-1,357,ykvN
3106,CDS,1442346,1442703,CDS,-1,357,ykvO
3107,gene,1442871,1443618,gene,1,747,ykvO
3108,CDS,1442871,1443618,CDS,1,747,ykvP
3109,gene,1444098,1445298,gene,1,1200,ykvP
3110,CDS,1444098,1445298,CDS,1,1200,ykzQ
3111,gene,1445313,1445541,gene,1,228,ykzQ
3112,CDS,1445313,1445541,CDS,1,228,ykvQ
3113,gene,1445637,1446336,gene,1,699,ykvQ
3114,misc_feature,1445637,1446336,else,1,699,ykzR
3115,gene,1446316,1446568,gene,1,252,ykzR
3116,misc_feature,1446316,1446568,else,1,252,ykvR
3118,CDS,1447250,1447541,CDS,1,291,ykvS
3117,gene,1447250,1447541,gene,1,291,ykvR
3119,gene,1447661,1447847,gene,-1,186,ykvS
3120,CDS,1447661,1447847,CDS,-1,186,ykzS
3121,gene,1448012,1448207,gene,1,195,ykzS
3122,CDS,1448012,1448207,CDS,1,195,ykvT
3123,gene,1448505,1449132,gene,1,627,ykvT
3124,CDS,1448505,1449132,CDS,1,627,ykvU
3125,gene,1449249,1450587,gene,1,1338,ykvU
3126,CDS,1449249,1450587,CDS,1,1338,stoA
3127,gene,1450637,1451135,gene,1,498,stoA
3128,CDS,1450637,1451135,CDS,1,498,pfeT
3129,gene,1451370,1453284,gene,1,1914,pfeT
3130,CDS,1451370,1453284,CDS,1,1914,papB
3131,gene,1453690,1454782,gene,1,1092,papB
3132,CDS,1453690,1454782,CDS,1,1092,ykvZ
3133,gene,1455063,1456029,gene,1,966,ykvZ
3134,CDS,1455063,1456029,CDS,1,966,glcT
3136,CDS,1456091,1456958,CDS,1,867,gswA
3135,gene,1456091,1456958,gene,1,867,glcT
3137,gene,1457004,1457156,gene,1,152,gswA
3138,misc_RNA,1457004,1457156,else,1,152,ptsG
3139,gene,1457186,1459286,gene,1,2100,ptsG
3140,CDS,1457186,1459286,CDS,1,2100,ptsH
3141,gene,1459383,1459650,gene,1,267,ptsH
3142,CDS,1459383,1459650,CDS,1,267,ptsI
3144,CDS,1459649,1461362,CDS,1,1713,splA
3143,gene,1459649,1461362,gene,1,1713,ptsI
3145,gene,1461452,1461692,gene,1,240,splA
3146,CDS,1461452,1461692,CDS,1,240,splB
3147,gene,1461769,1462798,gene,1,1029,splB
3148,CDS,1461769,1462798,CDS,1,1029,ykwB
3149,gene,1462812,1463493,gene,-1,681,ykwB
3150,CDS,1462812,1463493,CDS,-1,681,mcpC
3152,CDS,1463627,1465595,CDS,1,1968,ohaC
3151,gene,1463627,1465595,gene,1,1968,mcpC
3154,CDS,1465732,1466599,CDS,1,867,ykwD
3153,gene,1465732,1466599,gene,1,867,ohaC
3155,gene,1466637,1467411,gene,-1,774,ykwD
3156,CDS,1466637,1467411,CDS,-1,774,pbpH
3157,gene,1467747,1469862,gene,1,2115,pbpH
3158,CDS,1467747,1469862,CDS,1,2115,kinA
3159,gene,1470025,1471846,gene,1,1821,kinA
3160,CDS,1470025,1471846,CDS,1,1821,dapX
3161,gene,1471856,1473038,gene,-1,1182,dapX
3162,CDS,1471856,1473038,CDS,-1,1182,ykzT
3164,CDS,1473239,1473401,CDS,-1,162,cheV
3163,gene,1473239,1473401,gene,-1,162,ykzT
3165,gene,1473604,1474516,gene,1,912,cheV
3166,CDS,1473604,1474516,CDS,1,912,kre
3167,gene,1474559,1475024,gene,-1,465,kre
3168,CDS,1474559,1475024,CDS,-1,465,ykuC
3169,gene,1475149,1476442,gene,-1,1293,ykuC
3170,CDS,1475149,1476442,CDS,-1,1293,ltdD
3172,CDS,1476517,1477012,CDS,-1,495,ppeE
3171,gene,1476517,1477012,gene,-1,495,ltdD
3173,gene,1477068,1477929,gene,-1,861,ppeE
3174,CDS,1477068,1477929,CDS,-1,861,fadH
3175,gene,1478071,1478836,gene,1,765,fadH
3176,CDS,1478071,1478836,CDS,1,765,ykuG
3177,gene,1479136,1480867,gene,1,1731,ykuG
3178,CDS,1479136,1480867,CDS,1,1731,ykzU
3179,gene,1480932,1481451,gene,1,519,ykzU
3180,CDS,1480932,1481451,CDS,1,519,ykuH
3181,gene,1481546,1482095,gene,1,549,ykuH
3182,CDS,1481546,1482095,CDS,1,549,ykuI
3183,gene,1482247,1483471,gene,1,1224,ykuI
3184,CDS,1482247,1483471,CDS,1,1224,fsrA
3185,gene,1483556,1483640,gene,1,84,fsrA
3186,misc_RNA,1483556,1483640,else,1,84,ykuJ
3188,CDS,1484116,1484356,CDS,1,240,ykuK
3187,gene,1484116,1484356,gene,1,240,ykuJ
3189,gene,1484465,1484984,gene,1,519,ykuK
3190,CDS,1484465,1484984,CDS,1,519,abbA
3191,gene,1485117,1485315,gene,1,198,abbA
3192,CDS,1485117,1485315,CDS,1,198,ykuL
3193,gene,1485452,1485896,gene,1,444,ykuL
3194,CDS,1485452,1485896,CDS,1,444,ccpC
3195,gene,1486044,1486926,gene,1,882,ccpC
3196,CDS,1486044,1486926,CDS,1,882,fldN
3197,gene,1487037,1487514,gene,1,477,fldN
3198,CDS,1487037,1487514,CDS,1,477,ykuO
3199,gene,1487503,1488397,gene,1,894,ykuO
3200,CDS,1487503,1488397,CDS,1,894,fldP
3201,gene,1488412,1488868,gene,1,456,fldP
3202,CDS,1488412,1488868,CDS,1,456,dapH
3204,CDS,1488972,1489683,CDS,1,711,dapI
3203,gene,1488972,1489683,gene,1,711,dapH
3205,gene,1489752,1490877,gene,1,1125,dapI
3206,CDS,1489752,1490877,CDS,1,1125,ykuS
3207,gene,1490938,1491184,gene,1,246,ykuS
3208,CDS,1490938,1491184,CDS,1,246,mscT
3209,gene,1491220,1492024,gene,-1,804,mscT
3210,CDS,1491220,1492024,CDS,-1,804,ahpA
3212,CDS,1492260,1492803,CDS,1,543,ykuV
3211,gene,1492260,1492803,gene,1,543,ahpA
3213,gene,1492874,1493321,gene,1,447,ykuV
3214,CDS,1492874,1493321,CDS,1,447,rok
3215,gene,1493786,1494362,gene,1,576,rok
3216,CDS,1493786,1494362,CDS,1,576,sppO
3217,gene,1494402,1495368,gene,-1,966,sppO
3218,CDS,1494402,1495368,CDS,-1,966,mobA
3219,gene,1495504,1496104,gene,1,600,mobA
3220,CDS,1495504,1496104,CDS,1,600,moeB
3222,CDS,1496154,1497174,CDS,1,1020,moeA
3221,gene,1496154,1497174,gene,1,1020,moeB
3223,gene,1497191,1498484,gene,1,1293,moeA
3224,CDS,1497191,1498484,CDS,1,1293,mobB
3225,gene,1498444,1498966,gene,1,522,mobB
3226,CDS,1498444,1498966,CDS,1,522,moaE
3227,gene,1498965,1499439,gene,1,474,moaE
3228,CDS,1498965,1499439,CDS,1,474,moaD
3230,CDS,1499431,1499665,CDS,1,234,yknU
3229,gene,1499431,1499665,gene,1,234,moaD
3231,gene,1499888,1501646,gene,1,1758,yknU
3232,CDS,1499888,1501646,CDS,1,1758,yknV
3233,gene,1501657,1503472,gene,1,1815,yknV
3234,CDS,1501657,1503472,CDS,1,1815,skiW
3235,gene,1503581,1504277,gene,1,696,skiW
3236,CDS,1503581,1504277,CDS,1,696,skiX
3237,gene,1504281,1505415,gene,1,1134,skiX
3238,CDS,1504281,1505415,CDS,1,1134,skiY
3240,CDS,1505415,1506108,CDS,1,693,skiZ
3239,gene,1505415,1506108,gene,1,693,skiY
3241,gene,1506104,1507298,gene,1,1194,skiZ
3242,CDS,1506104,1507298,CDS,1,1194,fruR
3243,gene,1507577,1508333,gene,1,756,fruR
3244,CDS,1507577,1508333,CDS,1,756,fruK
3245,gene,1508329,1509241,gene,1,912,fruK
3246,CDS,1508329,1509241,CDS,1,912,fruA
3247,gene,1509255,1511163,gene,1,1908,fruA
3248,CDS,1509255,1511163,CDS,1,1908,sipT
3249,gene,1511307,1511889,gene,1,582,sipT
3250,CDS,1511307,1511889,CDS,1,582,ykoA
3251,gene,1511922,1512192,gene,-1,270,ykoA
3252,CDS,1511922,1512192,CDS,-1,270,ykpA
3253,gene,1512372,1513995,gene,1,1623,ykpA
3254,CDS,1512372,1513995,CDS,1,1623,panE
3255,gene,1514051,1514963,gene,1,912,panE
3256,CDS,1514051,1514963,CDS,1,912,ampS
3258,CDS,1514996,1516229,CDS,-1,1233,ykpC
3257,gene,1514996,1516229,gene,-1,1233,ampS
3259,gene,1516338,1516473,gene,-1,135,ykpC
3260,CDS,1516338,1516473,CDS,-1,135,mreBH
3261,gene,1516573,1517581,gene,-1,1008,mreBH
3262,CDS,1516573,1517581,CDS,-1,1008,abhA
3263,gene,1517864,1518143,gene,1,279,abhA
3264,CDS,1517864,1518143,CDS,1,279,kinC
3265,gene,1518332,1519619,gene,1,1287,kinC
3266,CDS,1518332,1519619,CDS,1,1287,ykqA
3267,gene,1519634,1520468,gene,1,834,ykqA
3268,CDS,1519634,1520468,CDS,1,834,ktrC
3269,gene,1520530,1521196,gene,1,666,ktrC
3270,CDS,1520530,1521196,CDS,1,666,adeC
3271,gene,1521350,1523084,gene,1,1734,adeC
3272,CDS,1521350,1523084,CDS,1,1734,rnjA
3274,CDS,1523117,1524785,CDS,-1,1668,rnpZA
3273,gene,1523117,1524785,gene,-1,1668,rnjA
3275,gene,1524790,1525000,gene,-1,210,rnpZA
3276,CDS,1524790,1525000,CDS,-1,210,ykrA
3277,gene,1525385,1526159,gene,1,774,ykrA
3278,CDS,1525385,1526159,CDS,1,774,defB
3279,gene,1526194,1526749,gene,-1,555,defB
3280,CDS,1526194,1526749,CDS,-1,555,ykzV
3282,CDS,1526858,1527017,CDS,-1,159,BSU_14568
3281,gene,1526858,1527017,gene,-1,159,ykzV
3283,gene,1526923,1527067,gene,-1,144,BSU_14568
3284,CDS,1526923,1527067,CDS,-1,144,ykyA
3285,gene,1527230,1527902,gene,1,672,ykyA
3286,CDS,1527230,1527902,CDS,1,672,pdhA
3287,gene,1528325,1529441,gene,1,1116,pdhA
3288,CDS,1528325,1529441,CDS,1,1116,pdhB
3289,gene,1529444,1530422,gene,1,978,pdhB
3290,CDS,1529444,1530422,CDS,1,978,pdhC
3292,CDS,1530536,1531865,CDS,1,1329,pdhD
3291,gene,1530536,1531865,gene,1,1329,pdhC
3293,gene,1531869,1533282,gene,1,1413,pdhD
3294,CDS,1531869,1533282,CDS,1,1413,slp
3295,gene,1533326,1533701,gene,-1,375,slp
3296,CDS,1533326,1533701,CDS,-1,375,srrA
3297,gene,1534069,1534280,gene,1,211,srrA
3298,misc_RNA,1534069,1534280,else,1,211,rgpA
3300,CDS,1534119,1534239,CDS,1,120,speA
3299,gene,1534119,1534239,gene,1,120,rgpA
3301,gene,1534278,1535751,gene,-1,1473,speA
3302,CDS,1534278,1535751,CDS,-1,1473,yktA
3303,gene,1535935,1536202,gene,1,267,yktA
3304,CDS,1535935,1536202,CDS,1,267,yktB
3305,gene,1536234,1536873,gene,-1,639,yktB
3306,CDS,1536234,1536873,CDS,-1,639,ykzI
3307,gene,1537112,1537301,gene,1,189,ykzI
3308,CDS,1537112,1537301,CDS,1,189,suhB
3310,CDS,1537440,1538238,CDS,1,798,ykzC
3309,gene,1537440,1538238,gene,1,798,suhB
3311,gene,1538263,1538692,gene,1,429,ykzC
3312,CDS,1538263,1538692,CDS,1,429,yktD
3313,gene,1538769,1539684,gene,-1,915,yktD
3314,CDS,1538769,1539684,CDS,-1,915,nprE
3315,gene,1540035,1541601,gene,-1,1566,nprE
3316,CDS,1540035,1541601,CDS,-1,1566,ylaA
3317,gene,1541885,1543826,gene,1,1941,ylaA
3318,CDS,1541885,1543826,CDS,1,1941,ylaB
3319,gene,1543815,1544085,gene,1,270,ylaB
3320,CDS,1543815,1544085,CDS,1,270,sigP
3321,gene,1544084,1544606,gene,1,522,sigP
3322,CDS,1544084,1544606,CDS,1,522,sigQ
3323,gene,1544602,1544896,gene,1,294,sigQ
3324,CDS,1544602,1544896,CDS,1,294,ylaE
3326,CDS,1544935,1545547,CDS,-1,612,ylaF
3325,gene,1544935,1545547,gene,-1,612,ylaE
3328,CDS,1545819,1546008,CDS,-1,189,bipA
3327,gene,1545819,1546008,gene,-1,189,ylaF
3329,gene,1546120,1547959,gene,1,1839,bipA
3330,CDS,1546120,1547959,CDS,1,1839,ylaH
3331,gene,1548015,1548333,gene,1,318,ylaH
3332,CDS,1548015,1548333,CDS,1,318,ylaI
3333,gene,1548388,1548598,gene,-1,210,ylaI
3334,CDS,1548388,1548598,CDS,-1,210,ylaJ
3335,gene,1548680,1549310,gene,-1,630,ylaJ
3336,CDS,1548680,1549310,CDS,-1,630,ylaK
3337,gene,1549464,1550793,gene,1,1329,ylaK
3338,CDS,1549464,1550793,CDS,1,1329,ylaL
3339,gene,1550796,1551282,gene,-1,486,ylaL
3340,CDS,1550796,1551282,CDS,-1,486,glsB
3341,gene,1551384,1552314,gene,1,930,glsB
3342,CDS,1551384,1552314,CDS,1,930,ylaN
3344,CDS,1552411,1552693,CDS,1,282,ftsW
3343,gene,1552411,1552693,gene,1,282,ylaN
3345,gene,1552898,1554110,gene,1,1212,ftsW
3346,CDS,1552898,1554110,CDS,1,1212,pycA
3347,gene,1554184,1557631,gene,1,3447,pycA
3348,CDS,1554184,1557631,CDS,1,3447,ctaA
3349,gene,1558033,1558954,gene,-1,921,ctaA
3350,CDS,1558033,1558954,CDS,-1,921,ctaB
3352,CDS,1559308,1560226,CDS,1,918,ctaC
3351,gene,1559308,1560226,gene,1,918,ctaB
3353,gene,1560465,1561536,gene,1,1071,ctaC
3354,CDS,1560465,1561536,CDS,1,1071,ctaD
3355,gene,1561568,1563437,gene,1,1869,ctaD
3356,CDS,1561568,1563437,CDS,1,1869,ctaE
3357,gene,1563436,1564060,gene,1,624,ctaE
3358,CDS,1563436,1564060,CDS,1,624,ctaF
3359,gene,1564062,1564395,gene,1,333,ctaF
3360,CDS,1564062,1564395,CDS,1,333,ctaG
3362,CDS,1564421,1565315,CDS,1,894,ylbA
3361,gene,1564421,1565315,gene,1,894,ctaG
3363,gene,1565346,1565709,gene,-1,363,ylbA
3364,CDS,1565346,1565709,CDS,-1,363,ylbB
3365,gene,1565848,1566295,gene,1,447,ylbB
3366,CDS,1565848,1566295,CDS,1,447,ylbC
3367,gene,1566378,1567419,gene,1,1041,ylbC
3368,CDS,1566378,1567419,CDS,1,1041,ylbD
3370,CDS,1567650,1568049,CDS,1,399,ylbE
3369,gene,1567650,1568049,gene,1,399,ylbD
3371,gene,1568064,1568304,gene,1,240,ylbE
3372,CDS,1568064,1568304,CDS,1,240,ricF
3373,gene,1568419,1568869,gene,1,450,ricF
3374,CDS,1568419,1568869,CDS,1,450,ylbG
3375,gene,1568923,1569196,gene,1,273,ylbG
3376,CDS,1568923,1569196,CDS,1,273,csfG
3377,gene,1569198,1569319,gene,1,121,csfG
3378,misc_RNA,1569198,1569319,else,1,121,rsmD
3380,CDS,1569518,1570073,CDS,1,555,coaD
3379,gene,1569518,1570073,gene,1,555,rsmD
3381,gene,1570077,1570563,gene,1,486,coaD
3382,CDS,1570077,1570563,CDS,1,486,spoVV
3383,gene,1570573,1571800,gene,-1,1227,spoVV
3384,CDS,1570573,1571800,CDS,-1,1227,ylbK
3385,gene,1571980,1572763,gene,1,783,ylbK
3386,CDS,1571980,1572763,CDS,1,783,ylbL
3387,gene,1572764,1573790,gene,1,1026,ylbL
3388,CDS,1572764,1573790,CDS,1,1026,ylbM
3389,gene,1573806,1575054,gene,-1,1248,ylbM
3390,CDS,1573806,1575054,CDS,-1,1248,ylzH
3391,gene,1575050,1575236,gene,-1,186,ylzH
3392,CDS,1575050,1575236,CDS,-1,186,ylbN
3393,gene,1575263,1575782,gene,1,519,ylbN
3394,CDS,1575263,1575782,CDS,1,519,rpmF
3395,gene,1575803,1575983,gene,1,180,rpmF
3396,CDS,1575803,1575983,CDS,1,180,gerR
3397,gene,1576128,1576710,gene,1,582,gerR
3398,CDS,1576128,1576710,CDS,1,582,ylbP
3400,CDS,1576766,1577249,CDS,-1,483,panE
3399,gene,1576766,1577249,gene,-1,483,ylbP
3402,CDS,1577408,1578305,CDS,1,897,bshC
3401,gene,1577408,1578305,gene,1,897,panE
3403,gene,1578375,1579995,gene,1,1620,bshC
3404,CDS,1578375,1579995,CDS,1,1620,mraZ
3405,gene,1580120,1580552,gene,1,432,mraZ
3406,CDS,1580120,1580552,CDS,1,432,rsmH
3407,gene,1580621,1581557,gene,1,936,rsmH
3408,CDS,1580621,1581557,CDS,1,936,ftsL
3409,gene,1581596,1581950,gene,1,354,ftsL
3410,CDS,1581596,1581950,CDS,1,354,pbpB
3411,gene,1581946,1584097,gene,1,2151,pbpB
3412,CDS,1581946,1584097,CDS,1,2151,spoVD
3413,gene,1584213,1586154,gene,1,1941,spoVD
3414,CDS,1584213,1586154,CDS,1,1941,murE
3415,gene,1586329,1587814,gene,1,1485,murE
3416,CDS,1586329,1587814,CDS,1,1485,mraY
3417,gene,1587925,1588900,gene,1,975,mraY
3418,CDS,1587925,1588900,CDS,1,975,murD
3420,CDS,1588900,1590256,CDS,1,1356,spoVE
3419,gene,1588900,1590256,gene,1,1356,murD
3421,gene,1590316,1591417,gene,1,1101,spoVE
3422,CDS,1590316,1591417,CDS,1,1101,murG
3423,gene,1591539,1592631,gene,1,1092,murG
3424,CDS,1591539,1592631,CDS,1,1092,murB
3425,gene,1592662,1593574,gene,1,912,murB
3426,CDS,1592662,1593574,CDS,1,912,divIB
3428,CDS,1593703,1594495,CDS,1,792,ylxW
3427,gene,1593703,1594495,gene,1,792,divIB
3429,gene,1594491,1595187,gene,1,696,ylxW
3430,CDS,1594491,1595187,CDS,1,696,ylxX
3431,gene,1595209,1595917,gene,1,708,ylxX
3432,CDS,1595209,1595917,CDS,1,708,sbp
3433,gene,1595934,1596300,gene,1,366,sbp
3434,CDS,1595934,1596300,CDS,1,366,ftsA
3436,CDS,1596473,1597796,CDS,1,1323,ftsZ
3435,gene,1596473,1597796,gene,1,1323,ftsA
3438,CDS,1597831,1598980,CDS,1,1149,bpr
3437,gene,1597831,1598980,gene,1,1149,ftsZ
3439,gene,1599282,1603584,gene,1,4302,bpr
3440,CDS,1599282,1603584,CDS,1,4302,spoIIGA
3441,gene,1603778,1604708,gene,1,930,spoIIGA
3442,CDS,1603778,1604708,CDS,1,930,sigE
3443,gene,1604770,1605490,gene,1,720,sigE
3444,CDS,1604770,1605490,CDS,1,720,sigG
3445,gene,1605629,1606412,gene,1,783,sigG
3446,CDS,1605629,1606412,CDS,1,783,ylmA
3448,CDS,1606559,1607354,CDS,1,795,tswE
3447,gene,1606559,1607354,gene,1,795,ylmA
3449,gene,1607366,1607468,gene,1,102,tswE
3450,misc_RNA,1607366,1607468,else,1,102,thiQ
3451,gene,1607555,1608836,gene,1,1281,thiQ
3452,CDS,1607555,1608836,CDS,1,1281,ylmC
3453,gene,1608918,1609164,gene,1,246,ylmC
3454,CDS,1608918,1609164,CDS,1,246,ylmD
3456,CDS,1609326,1610163,CDS,1,837,ylmE
3455,gene,1609326,1610163,gene,1,837,ylmD
3457,gene,1610169,1610862,gene,1,693,ylmE
3458,CDS,1610169,1610862,CDS,1,693,sepF
3459,gene,1610858,1611314,gene,1,456,sepF
3460,CDS,1610858,1611314,CDS,1,456,ylmG
3461,gene,1611320,1611593,gene,1,273,ylmG
3462,CDS,1611320,1611593,CDS,1,273,ylmH
3463,gene,1611653,1612427,gene,1,774,ylmH
3464,CDS,1611653,1612427,CDS,1,774,divIVA
3465,gene,1612520,1613015,gene,1,495,divIVA
3466,CDS,1612520,1613015,CDS,1,495,iswA
3467,gene,1613077,1613304,gene,1,227,iswA
3468,misc_RNA,1613077,1613304,else,1,227,ileS
3469,gene,1613356,1616122,gene,1,2766,ileS
3470,CDS,1613356,1616122,CDS,1,2766,ylyA
3472,CDS,1616266,1616641,CDS,1,375,lspA
3471,gene,1616266,1616641,gene,1,375,ylyA
3473,gene,1616743,1617208,gene,1,465,lspA
3474,CDS,1616743,1617208,CDS,1,465,rluD
3475,gene,1617209,1618121,gene,1,912,rluD
3476,CDS,1617209,1618121,CDS,1,912,pyaA
3477,gene,1618160,1618277,gene,1,117,pyaA
3478,misc_RNA,1618160,1618277,else,1,117,pyrR
3479,gene,1618303,1618849,gene,1,546,pyrR
3480,CDS,1618303,1618849,CDS,1,546,pyaB
3481,gene,1618852,1618970,gene,1,118,pyaB
3482,misc_RNA,1618852,1618970,else,1,118,pyrP
3483,gene,1619022,1620330,gene,1,1308,pyrP
3484,CDS,1619022,1620330,CDS,1,1308,pyaC
3485,gene,1620330,1620445,gene,1,115,pyaC
3486,misc_RNA,1620330,1620445,else,1,115,pyrB
3488,CDS,1620475,1621390,CDS,1,915,pyrC
3487,gene,1620475,1621390,gene,1,915,pyrB
3489,gene,1621373,1622660,gene,1,1287,pyrC
3490,CDS,1621373,1622660,CDS,1,1287,pyrAA
3491,gene,1622656,1623751,gene,1,1095,pyrAA
3492,CDS,1622656,1623751,CDS,1,1095,pyrAB
3493,gene,1623735,1626951,gene,1,3216,pyrAB
3494,CDS,1623735,1626951,CDS,1,3216,pyrK
3496,CDS,1626947,1627718,CDS,1,771,pyrD
3495,gene,1626947,1627718,gene,1,771,pyrK
3497,gene,1627717,1628653,gene,1,936,pyrD
3498,CDS,1627717,1628653,CDS,1,936,pyrF
3499,gene,1628621,1629341,gene,1,720,pyrF
3500,CDS,1628621,1629341,CDS,1,720,pyrE
3501,gene,1629319,1629970,gene,1,651,pyrE
3502,CDS,1629319,1629970,CDS,1,651,mswE
3503,gene,1630114,1630220,gene,1,106,mswE
3504,misc_RNA,1630114,1630220,else,1,106,cysH
3506,CDS,1630381,1631083,CDS,1,702,cysP
3505,gene,1630381,1631083,gene,1,702,cysH
3507,gene,1631094,1632159,gene,1,1065,cysP
3508,CDS,1631094,1632159,CDS,1,1065,sat
3509,gene,1632207,1633356,gene,1,1149,sat
3510,CDS,1632207,1633356,CDS,1,1149,cysC
3511,gene,1633368,1633962,gene,1,594,cysC
3512,CDS,1633368,1633962,CDS,1,594,sumT
3514,CDS,1634060,1634834,CDS,1,774,sirB
3513,gene,1634060,1634834,gene,1,774,sumT
3515,gene,1634836,1635622,gene,1,786,sirB
3516,CDS,1634836,1635622,CDS,1,786,sirC
3517,gene,1635602,1636091,gene,1,489,sirC
3518,CDS,1635602,1636091,CDS,1,489,fbnA
3519,gene,1636130,1637849,gene,-1,1719,fbnA
3520,CDS,1636130,1637849,CDS,-1,1719,tcaB
3521,gene,1637964,1640637,gene,1,2673,tcaB
3522,CDS,1637964,1640637,CDS,1,2673,yloC
3524,CDS,1640719,1641595,CDS,1,876,remA
3523,gene,1640719,1641595,gene,1,876,yloC
3525,gene,1641671,1641941,gene,1,270,remA
3526,CDS,1641671,1641941,CDS,1,270,gmk
3527,gene,1641948,1642563,gene,1,615,gmk
3528,CDS,1641948,1642563,CDS,1,615,rpoZ
3529,gene,1642566,1642770,gene,1,204,rpoZ
3530,CDS,1642566,1642770,CDS,1,204,coaBC
3531,gene,1642850,1644071,gene,1,1221,coaBC
3532,CDS,1642850,1644071,CDS,1,1221,priA
3533,gene,1644067,1646485,gene,1,2418,priA
3534,CDS,1644067,1646485,CDS,1,2418,defA
3535,gene,1646511,1646994,gene,1,483,defA
3536,CDS,1646511,1646994,CDS,1,483,fmt
3537,gene,1646998,1647952,gene,1,954,fmt
3538,CDS,1646998,1647952,CDS,1,954,rsmB
3539,gene,1647938,1649282,gene,1,1344,rsmB
3540,CDS,1647938,1649282,CDS,1,1344,rlmN
3542,CDS,1649285,1650377,CDS,1,1092,prpC
3541,gene,1649285,1650377,gene,1,1092,rlmN
3543,gene,1650383,1651148,gene,1,765,prpC
3544,CDS,1650383,1651148,CDS,1,765,prkC
3545,gene,1651141,1653088,gene,1,1947,prkC
3546,CDS,1651141,1653088,CDS,1,1947,rsgA
3547,gene,1653102,1653999,gene,1,897,rsgA
3548,CDS,1653102,1653999,CDS,1,897,rpe
3549,gene,1654003,1654657,gene,1,654,rpe
3550,CDS,1654003,1654657,CDS,1,654,thiN
3551,gene,1654729,1655374,gene,1,645,thiN
3552,CDS,1654729,1655374,CDS,1,645,spoVM
3553,gene,1655445,1655526,gene,1,81,spoVM
3554,CDS,1655445,1655526,CDS,1,81,rpmB
3555,gene,1655598,1655787,gene,-1,189,rpmB
3556,CDS,1655598,1655787,CDS,-1,189,yloU
3558,CDS,1656063,1656426,CDS,1,363,yloV
3557,gene,1656063,1656426,gene,1,363,yloU
3559,gene,1656441,1658103,gene,1,1662,yloV
3560,CDS,1656441,1658103,CDS,1,1662,sdaAB
3561,gene,1658241,1658904,gene,1,663,sdaAB
3562,CDS,1658241,1658904,CDS,1,663,sdaAA
3563,gene,1658929,1659832,gene,1,903,sdaAA
3564,CDS,1658929,1659832,CDS,1,903,recG
3566,CDS,1659809,1661858,CDS,1,2049,fapR
3565,gene,1659809,1661858,gene,1,2049,recG
3567,gene,1661966,1662533,gene,1,567,fapR
3568,CDS,1661966,1662533,CDS,1,567,plsX
3569,gene,1662546,1663548,gene,1,1002,plsX
3570,CDS,1662546,1663548,CDS,1,1002,fabD
3571,gene,1663566,1664520,gene,1,954,fabD
3572,CDS,1663566,1664520,CDS,1,954,fabG
3573,gene,1664512,1665253,gene,1,741,fabG
3574,CDS,1664512,1665253,CDS,1,741,acpA
3576,CDS,1665336,1665570,CDS,1,234,rnc
3575,gene,1665336,1665570,gene,1,234,acpA
3577,gene,1665709,1666459,gene,1,750,rnc
3578,CDS,1665709,1666459,CDS,1,750,smc
3579,gene,1666559,1670120,gene,1,3561,smc
3580,CDS,1666559,1670120,CDS,1,3561,ftsY
3581,gene,1670139,1671129,gene,1,990,ftsY
3582,CDS,1670139,1671129,CDS,1,990,ylqB
3584,CDS,1671165,1671651,CDS,-1,486,ylxM
3583,gene,1671165,1671651,gene,-1,486,ylqB
3585,gene,1671827,1672160,gene,1,333,ylxM
3586,CDS,1671827,1672160,CDS,1,333,ffh
3587,gene,1672173,1673514,gene,1,1341,ffh
3588,CDS,1672173,1673514,CDS,1,1341,rpsP
3589,gene,1673619,1673892,gene,1,273,rpsP
3590,CDS,1673619,1673892,CDS,1,273,ylqC
3591,gene,1673891,1674137,gene,1,246,ylqC
3592,CDS,1673891,1674137,CDS,1,246,ylqD
3594,CDS,1674258,1674645,CDS,1,387,rimM
3593,gene,1674258,1674645,gene,1,387,ylqD
3595,gene,1674649,1675174,gene,1,525,rimM
3596,CDS,1674649,1675174,CDS,1,525,trmD
3597,gene,1675170,1675902,gene,1,732,trmD
3598,CDS,1675170,1675902,CDS,1,732,BSU_misc_RNA_30
3599,gene,1675980,1676022,gene,1,42,BSU_misc_RNA_30
3600,misc_RNA,1675980,1676022,else,1,42,rplS
3601,gene,1676041,1676389,gene,1,348,rplS
3602,CDS,1676041,1676389,CDS,1,348,rbgA
3603,gene,1676531,1677380,gene,1,849,rbgA
3604,CDS,1676531,1677380,CDS,1,849,rnhB
3605,gene,1677450,1678218,gene,1,768,rnhB
3606,CDS,1677450,1678218,CDS,1,768,ylqG
3607,gene,1678249,1679980,gene,1,1731,ylqG
3608,CDS,1678249,1679980,CDS,1,1731,ylqH
3610,CDS,1679976,1680258,CDS,1,282,sucC
3609,gene,1679976,1680258,gene,1,282,ylqH
3612,CDS,1680430,1681588,CDS,1,1158,sucD
3611,gene,1680430,1681588,gene,1,1158,sucC
3613,gene,1681616,1682519,gene,1,903,sucD
3614,CDS,1681616,1682519,CDS,1,903,dprA
3615,gene,1682579,1683473,gene,1,894,dprA
3616,CDS,1682579,1683473,CDS,1,894,topA
3617,gene,1683660,1685736,gene,1,2076,topA
3618,CDS,1683660,1685736,CDS,1,2076,trmFO
3619,gene,1685811,1687119,gene,1,1308,trmFO
3620,CDS,1685811,1687119,CDS,1,1308,codV
3621,gene,1687186,1688101,gene,1,915,codV
3622,CDS,1687186,1688101,CDS,1,915,clpQ
3623,gene,1688113,1688659,gene,1,546,clpQ
3624,CDS,1688113,1688659,CDS,1,546,clpY
3625,gene,1688675,1690079,gene,1,1404,clpY
3626,CDS,1688675,1690079,CDS,1,1404,codY
3628,CDS,1690118,1690898,CDS,1,780,flgB
3627,gene,1690118,1690898,gene,1,780,codY
3629,gene,1691277,1691667,gene,1,390,flgB
3630,CDS,1691277,1691667,CDS,1,390,flgC
3631,gene,1691666,1692119,gene,1,453,flgC
3632,CDS,1691666,1692119,CDS,1,453,fliE
3633,gene,1692129,1692450,gene,1,321,fliE
3634,CDS,1692129,1692450,CDS,1,321,fliF
3636,CDS,1692495,1694106,CDS,1,1611,fliG
3635,gene,1692495,1694106,gene,1,1611,fliF
3637,gene,1694118,1695135,gene,1,1017,fliG
3638,CDS,1694118,1695135,CDS,1,1017,fliH
3639,gene,1695253,1695880,gene,1,627,fliH
3640,CDS,1695253,1695880,CDS,1,627,fliI
3641,gene,1695876,1697193,gene,1,1317,fliI
3642,CDS,1695876,1697193,CDS,1,1317,fliJ
3643,gene,1697195,1697639,gene,1,444,fliJ
3644,CDS,1697195,1697639,CDS,1,444,ylxF
3646,CDS,1697650,1698265,CDS,1,615,fliK
3645,gene,1697650,1698265,gene,1,615,ylxF
3647,gene,1698277,1699741,gene,1,1464,fliK
3648,CDS,1698277,1699741,CDS,1,1464,flgD
3649,gene,1699737,1700160,gene,1,423,flgD
3650,CDS,1699737,1700160,CDS,1,423,flgE
3651,gene,1700181,1700976,gene,1,795,flgE
3652,CDS,1700181,1700976,CDS,1,795,swrD
3654,CDS,1701015,1701231,CDS,1,216,fliL
3653,gene,1701015,1701231,gene,1,216,swrD
3655,gene,1701227,1701650,gene,1,423,fliL
3656,CDS,1701227,1701650,CDS,1,423,fliM
3657,gene,1701683,1702682,gene,1,999,fliM
3658,CDS,1701683,1702682,CDS,1,999,fliY
3659,gene,1702671,1703808,gene,1,1137,fliY
3660,CDS,1702671,1703808,CDS,1,1137,cheY
3661,gene,1703833,1704196,gene,1,363,cheY
3662,CDS,1703833,1704196,CDS,1,363,fliZ
3664,CDS,1704210,1704870,CDS,1,660,fliP
3663,gene,1704210,1704870,gene,1,660,fliZ
3665,gene,1704862,1705528,gene,1,666,fliP
3666,CDS,1704862,1705528,CDS,1,666,fliQ
3667,gene,1705542,1705812,gene,1,270,fliQ
3668,CDS,1705542,1705812,CDS,1,270,fliR
3669,gene,1705819,1706599,gene,1,780,fliR
3670,CDS,1705819,1706599,CDS,1,780,flhB
3671,gene,1706598,1707681,gene,1,1083,flhB
3672,CDS,1706598,1707681,CDS,1,1083,flhA
3673,gene,1707713,1709747,gene,1,2034,flhA
3674,CDS,1707713,1709747,CDS,1,2034,flhF
3675,gene,1709746,1710847,gene,1,1101,flhF
3676,CDS,1709746,1710847,CDS,1,1101,flhG
3677,gene,1710837,1711734,gene,1,897,flhG
3678,CDS,1710837,1711734,CDS,1,897,cheB
3679,gene,1711735,1712809,gene,1,1074,cheB
3680,CDS,1711735,1712809,CDS,1,1074,cheA
3681,gene,1712814,1714833,gene,1,2019,cheA
3682,CDS,1712814,1714833,CDS,1,2019,cheW
3684,CDS,1714854,1715325,CDS,1,471,cheC
3683,gene,1714854,1715325,gene,1,471,cheW
3685,gene,1715343,1715973,gene,1,630,cheC
3686,CDS,1715343,1715973,CDS,1,630,cheD
3687,gene,1715969,1716470,gene,1,501,cheD
3688,CDS,1715969,1716470,CDS,1,501,sigD
3689,gene,1716492,1717257,gene,1,765,sigD
3690,CDS,1716492,1717257,CDS,1,765,swrB
3691,gene,1717285,1717789,gene,1,504,swrB
3692,CDS,1717285,1717789,CDS,1,504,rpsB
3693,gene,1717932,1718673,gene,1,741,rpsB
3694,CDS,1717932,1718673,CDS,1,741,tsf
3695,gene,1718774,1719656,gene,1,882,tsf
3696,CDS,1718774,1719656,CDS,1,882,pyrH
3697,gene,1719801,1720524,gene,1,723,pyrH
3698,CDS,1719801,1720524,CDS,1,723,frr
3700,CDS,1720525,1721083,CDS,1,558,uppS
3699,gene,1720525,1721083,gene,1,558,frr
3701,gene,1721213,1721996,gene,1,783,uppS
3702,CDS,1721213,1721996,CDS,1,783,cdsA
3703,gene,1721999,1722809,gene,1,810,cdsA
3704,CDS,1721999,1722809,CDS,1,810,dxr
3705,gene,1722870,1724022,gene,1,1152,dxr
3706,CDS,1722870,1724022,CDS,1,1152,rasP
3708,CDS,1724028,1725297,CDS,1,1269,proS
3707,gene,1724028,1725297,gene,1,1269,rasP
3709,gene,1725329,1727024,gene,1,1695,proS
3710,CDS,1725329,1727024,CDS,1,1695,polC
3711,gene,1727132,1731446,gene,1,4314,polC
3712,CDS,1727132,1731446,CDS,1,4314,surG
3713,gene,1731456,1731674,gene,1,218,surG
3714,misc_RNA,1731456,1731674,else,1,218,rimP
3715,gene,1731775,1732246,gene,1,471,rimP
3716,CDS,1731775,1732246,CDS,1,471,nusA
3718,CDS,1732280,1733396,CDS,1,1116,rulR
3717,gene,1732280,1733396,gene,1,1116,nusA
3719,gene,1733409,1733685,gene,1,276,rulR
3720,CDS,1733409,1733685,CDS,1,276,rulQ
3721,gene,1733686,1733989,gene,1,303,rulQ
3722,CDS,1733686,1733989,CDS,1,303,infB
3723,gene,1734008,1736159,gene,1,2151,infB
3724,CDS,1734008,1736159,CDS,1,2151,ylxP
3726,misc_feature,1736155,1736434,else,1,279,rbfA
3725,gene,1736155,1736434,gene,1,279,ylxP
3727,gene,1736450,1736804,gene,1,354,rbfA
3728,CDS,1736450,1736804,CDS,1,354,truB
3729,gene,1736885,1737815,gene,1,930,truB
3730,CDS,1736885,1737815,CDS,1,930,ribC
3731,gene,1737833,1738784,gene,1,951,ribC
3732,CDS,1737833,1738784,CDS,1,951,rpsO
3733,gene,1738940,1739210,gene,1,270,rpsO
3734,CDS,1738940,1739210,CDS,1,270,pnpA
3736,CDS,1739382,1741500,CDS,1,2118,ylxY
3735,gene,1739382,1741500,gene,1,2118,pnpA
3737,gene,1741617,1742577,gene,1,960,ylxY
3738,CDS,1741617,1742577,CDS,1,960,mlpA
3739,gene,1742616,1743846,gene,1,1230,mlpA
3740,CDS,1742616,1743846,CDS,1,1230,ymxH
3741,gene,1743923,1744181,gene,1,258,ymxH
3742,CDS,1743923,1744181,CDS,1,258,spoVFA
3743,gene,1744366,1745260,gene,1,894,spoVFA
3744,CDS,1744366,1745260,CDS,1,894,spoVFB
3745,gene,1745262,1745865,gene,1,603,spoVFB
3746,CDS,1745262,1745865,CDS,1,603,asd
3747,gene,1745990,1747031,gene,1,1041,asd
3748,CDS,1745990,1747031,CDS,1,1041,dapG
3749,gene,1747122,1748337,gene,1,1215,dapG
3750,CDS,1747122,1748337,CDS,1,1215,dapA
3751,gene,1748367,1749240,gene,1,873,dapA
3752,CDS,1748367,1749240,CDS,1,873,rnjB
3754,CDS,1749417,1751085,CDS,1,1668,tepA
3753,gene,1749417,1751085,gene,1,1668,rnjB
3755,gene,1751200,1751938,gene,1,738,tepA
3756,CDS,1751200,1751938,CDS,1,738,tepJ
3757,gene,1751934,1752147,gene,1,213,tepJ
3758,CDS,1751934,1752147,CDS,1,213,spoIIIE
3759,gene,1752277,1754641,gene,1,2364,spoIIIE
3760,CDS,1752277,1754641,CDS,1,2364,ymfC
3762,CDS,1754784,1755510,CDS,1,726,bcbE
3761,gene,1754784,1755510,gene,1,726,ymfC
3763,gene,1755648,1756857,gene,1,1209,bcbE
3764,CDS,1755648,1756857,CDS,1,1209,ymfF
3765,gene,1757036,1758317,gene,1,1281,ymfF
3766,CDS,1757036,1758317,CDS,1,1281,ymfH
3767,gene,1758313,1759600,gene,1,1287,ymfH
3768,CDS,1758313,1759600,CDS,1,1287,efpI
3770,CDS,1759654,1760383,CDS,1,729,ymfJ
3769,gene,1759654,1760383,gene,1,729,efpI
3772,CDS,1760463,1760721,CDS,1,258,ymfKn
3771,gene,1760463,1760721,gene,1,258,ymfJ
3773,gene,1760850,1761303,gene,1,453,ymfKn
3774,misc_feature,1760850,1761303,else,1,453,ymfKc
3775,gene,1761301,1761640,gene,1,339,ymfKc
3776,misc_feature,1761301,1761640,else,1,339,rodZ
3777,gene,1761706,1762573,gene,1,867,rodZ
3778,CDS,1761706,1762573,CDS,1,867,pgsA
3779,gene,1762622,1763204,gene,1,582,pgsA
3780,CDS,1762622,1763204,CDS,1,582,cinA
3782,CDS,1763221,1764472,CDS,1,1251,recA
3781,gene,1763221,1764472,gene,1,1251,cinA
3783,gene,1764644,1765691,gene,1,1047,recA
3784,CDS,1764644,1765691,CDS,1,1047,pbpX
3785,gene,1765858,1767034,gene,1,1176,pbpX
3786,CDS,1765858,1767034,CDS,1,1176,rny
3787,gene,1767309,1768872,gene,1,1563,rny
3788,CDS,1767309,1768872,CDS,1,1563,pdeB
3790,CDS,1768940,1769735,CDS,1,795,spoVS
3789,gene,1768940,1769735,gene,1,795,pdeB
3791,gene,1769934,1770195,gene,1,261,spoVS
3792,CDS,1769934,1770195,CDS,1,261,tdh
3793,gene,1770460,1771504,gene,1,1044,tdh
3794,CDS,1770460,1771504,CDS,1,1044,kbl
3795,gene,1771516,1772695,gene,1,1179,kbl
3796,CDS,1771516,1772695,CDS,1,1179,miaB
3797,gene,1772842,1774372,gene,1,1530,miaB
3798,CDS,1772842,1774372,CDS,1,1530,ricA
3799,gene,1774373,1774805,gene,1,432,ricA
3800,CDS,1774373,1774805,CDS,1,432,cotE
3801,gene,1775066,1775612,gene,1,546,cotE
3802,CDS,1775066,1775612,CDS,1,546,mutS
3803,gene,1775744,1778321,gene,1,2577,mutS
3804,CDS,1775744,1778321,CDS,1,2577,mutL
3806,CDS,1778336,1780220,CDS,1,1884,surX
3805,gene,1778336,1780220,gene,1,1884,mutL
3807,gene,1780403,1780554,gene,-1,151,surX
3808,misc_RNA,1780403,1780554,else,-1,151,ymzD
3809,gene,1780617,1781073,gene,-1,456,ymzD
3810,CDS,1780617,1781073,CDS,-1,456,ymcC
3811,gene,1781227,1781785,gene,-1,558,ymcC
3812,CDS,1781227,1781785,CDS,-1,558,pksA
3814,CDS,1781905,1782523,CDS,1,618,pksB
3813,gene,1781905,1782523,gene,1,618,pksA
3815,gene,1782712,1783390,gene,1,678,pksB
3816,CDS,1782712,1783390,CDS,1,678,BSU_17099
3817,gene,1783499,1783766,gene,1,267,BSU_17099
3818,CDS,1783499,1783766,CDS,1,267,pksC
3819,gene,1783762,1784629,gene,1,867,pksC
3820,CDS,1783762,1784629,CDS,1,867,pksD
3821,gene,1785132,1786107,gene,1,975,pksD
3822,CDS,1785132,1786107,CDS,1,975,pksE
3824,CDS,1786103,1788407,CDS,1,2304,acpK
3823,gene,1786103,1788407,gene,1,2304,pksE
3826,CDS,1788468,1788717,CDS,1,249,pksF
3825,gene,1788468,1788717,gene,1,249,acpK
3827,gene,1788694,1789942,gene,1,1248,pksF
3828,CDS,1788694,1789942,CDS,1,1248,pksG
3829,gene,1789942,1791205,gene,1,1263,pksG
3830,CDS,1789942,1791205,CDS,1,1263,pksH
3831,gene,1791192,1791972,gene,1,780,pksH
3832,CDS,1791192,1791972,CDS,1,780,pksI
3833,gene,1792011,1792761,gene,1,750,pksI
3834,CDS,1792011,1792761,CDS,1,750,pksJ
3835,gene,1792805,1807937,gene,1,15132,pksJ
3836,CDS,1792805,1807937,CDS,1,15132,pksL
3837,gene,1807920,1821537,gene,1,13617,pksL
3838,CDS,1807920,1821537,CDS,1,13617,pksM
3839,gene,1821552,1834341,gene,1,12789,pksM
3840,CDS,1821552,1834341,CDS,1,12789,pksN
3841,gene,1834408,1850875,gene,1,16467,pksN
3842,CDS,1834408,1850875,CDS,1,16467,pksR
3844,CDS,1850889,1858521,CDS,1,7632,pksS
3843,gene,1850889,1858521,gene,1,7632,pksR
3845,gene,1858565,1859783,gene,-1,1218,pksS
3846,CDS,1858565,1859783,CDS,-1,1218,ymzB
3847,gene,1860013,1860370,gene,-1,357,ymzB
3848,CDS,1860013,1860370,CDS,-1,357,ymaE
3849,gene,1860448,1861273,gene,-1,825,ymaE
3850,CDS,1860448,1861273,CDS,-1,825,aprX
3852,CDS,1861383,1862712,CDS,-1,1329,ymzEn
3851,gene,1861383,1862712,gene,-1,1329,aprX
3853,gene,1862936,1862993,gene,1,57,ymzEn
3854,misc_feature,1862936,1862993,else,1,57,ymzEc
3855,gene,1862991,1863168,gene,1,177,ymzEc
3856,misc_feature,1862991,1863168,else,1,177,pghC
3857,gene,1863447,1864155,gene,1,708,pghC
3858,CDS,1863447,1864155,CDS,1,708,ymaD
3860,CDS,1864224,1864677,CDS,1,453,ebrB
3859,gene,1864224,1864677,gene,1,453,ymaD
3862,CDS,1864690,1865044,CDS,-1,354,ebrA
3861,gene,1864690,1865044,gene,-1,354,ebrB
3863,gene,1865057,1865375,gene,-1,318,ebrA
3864,CDS,1865057,1865375,CDS,-1,318,ymaG
3865,gene,1865511,1865787,gene,-1,276,ymaG
3866,CDS,1865511,1865787,CDS,-1,276,ymaF
3867,gene,1865875,1866289,gene,1,414,ymaF
3868,CDS,1865875,1866289,CDS,1,414,miaA
3869,gene,1866388,1867333,gene,1,945,miaA
3870,CDS,1866388,1867333,CDS,1,945,hfq
3872,CDS,1867372,1867594,CDS,1,222,ymzC
3871,gene,1867372,1867594,gene,1,222,hfq
3873,gene,1867789,1868062,gene,1,273,ymzC
3874,CDS,1867789,1868062,CDS,1,273,ymzA
3875,gene,1868143,1868374,gene,1,231,ymzA
3876,CDS,1868143,1868374,CDS,1,231,nrdI
3877,gene,1868616,1869009,gene,1,393,nrdI
3878,CDS,1868616,1869009,CDS,1,393,nrdE
3880,CDS,1868968,1871071,CDS,1,2103,nrdF
3879,gene,1868968,1871071,gene,1,2103,nrdE
3881,gene,1871088,1872078,gene,1,990,nrdF
3882,CDS,1871088,1872078,CDS,1,990,ymaB
3883,gene,1872127,1872748,gene,1,621,ymaB
3884,CDS,1872127,1872748,CDS,1,621,cwlC
3885,gene,1872811,1873579,gene,-1,768,cwlC
3886,CDS,1872811,1873579,CDS,-1,768,spoVK
3887,gene,1874202,1875171,gene,1,969,spoVK
3888,CDS,1874202,1875171,CDS,1,969,hflX
3889,gene,1875303,1876566,gene,1,1263,hflX
3890,CDS,1875303,1876566,CDS,1,1263,ynbB
3891,gene,1876583,1877849,gene,1,1266,ynbB
3892,CDS,1876583,1877849,CDS,1,1266,glnR
3893,gene,1877958,1878366,gene,1,408,glnR
3894,CDS,1877958,1878366,CDS,1,408,glnA
3896,CDS,1878424,1879759,CDS,1,1335,ynxB
3895,gene,1878424,1879759,gene,1,1335,glnA
3897,gene,1880086,1880377,gene,1,291,ynxB
3898,CDS,1880086,1880377,CDS,1,291,ynzF
3899,gene,1880622,1880967,gene,1,345,ynzF
3900,CDS,1880622,1880967,CDS,1,345,ynzG
3901,gene,1881097,1881349,gene,1,252,ynzG
3902,CDS,1881097,1881349,CDS,1,252,ynaB
3903,gene,1881535,1881970,gene,1,435,ynaB
3904,CDS,1881535,1881970,CDS,1,435,ynaC
3905,gene,1882039,1882831,gene,1,792,ynaC
3906,CDS,1882039,1882831,CDS,1,792,ynaD
3907,gene,1883165,1883678,gene,1,513,ynaD
3908,CDS,1883165,1883678,CDS,1,513,ynaE
3909,gene,1884237,1884879,gene,1,642,ynaE
3910,CDS,1884237,1884879,CDS,1,642,ynaF
3912,CDS,1884967,1885321,CDS,1,354,ynaG
3911,gene,1884967,1885321,gene,1,354,ynaF
3913,gene,1885364,1885640,gene,1,276,ynaG
3914,CDS,1885364,1885640,CDS,1,276,ynzI
3915,gene,1885752,1885917,gene,1,165,ynzI
3916,CDS,1885752,1885917,CDS,1,165,ynaI
3917,gene,1886056,1886527,gene,1,471,ynaI
3918,CDS,1886056,1886527,CDS,1,471,xynP
3920,CDS,1887351,1888743,CDS,1,1392,xynB
3919,gene,1887351,1888743,gene,1,1392,xynP
3921,gene,1888773,1890375,gene,1,1602,xynB
3922,CDS,1888773,1890375,CDS,1,1602,xylR
3923,gene,1890511,1891666,gene,-1,1155,xylR
3924,CDS,1890511,1891666,CDS,-1,1155,xylA
3925,gene,1891907,1893245,gene,1,1338,xylA
3926,CDS,1891907,1893245,CDS,1,1338,xylB
3927,gene,1893395,1894895,gene,1,1500,xylB
3928,CDS,1893395,1894895,CDS,1,1500,yncB
3930,CDS,1895377,1896013,CDS,-1,636,yncC
3929,gene,1895377,1896013,gene,-1,636,yncB
3931,gene,1896423,1897839,gene,1,1416,yncC
3932,CDS,1896423,1897839,CDS,1,1416,alrB
3933,gene,1897940,1899125,gene,-1,1185,alrB
3934,CDS,1897940,1899125,CDS,-1,1185,yncE
3935,gene,1899588,1900050,gene,1,462,yncE
3936,CDS,1899588,1900050,CDS,1,462,dutA
3938,CDS,1900079,1900514,CDS,1,435,cotU
3937,gene,1900079,1900514,gene,1,435,dutA
3939,gene,1901116,1901377,gene,-1,261,cotU
3940,CDS,1901116,1901377,CDS,-1,261,ynzJ
3941,gene,1901611,1901737,gene,1,126,ynzJ
3942,misc_feature,1901611,1901737,else,1,126,BSU_17679
3943,gene,1901780,1901945,gene,1,165,BSU_17679
3944,CDS,1901780,1901945,CDS,1,165,thyA
3945,gene,1902218,1903058,gene,1,840,thyA
3946,CDS,1902218,1903058,CDS,1,840,BSU_17689
3948,CDS,1903180,1903468,CDS,-1,288,yncM
3947,gene,1903180,1903468,gene,-1,288,BSU_17689
3949,gene,1903510,1904233,gene,-1,723,yncM
3950,CDS,1903510,1904233,CDS,-1,723,ynzK
3951,gene,1904392,1904749,gene,-1,357,ynzK
3952,CDS,1904392,1904749,CDS,-1,357,cotC
3953,gene,1904994,1905195,gene,-1,201,cotC
3954,CDS,1904994,1905195,CDS,-1,201,tatAC
3955,gene,1905369,1905558,gene,-1,189,tatAC
3956,CDS,1905369,1905558,CDS,-1,189,BSU_17715
3957,gene,1905636,1905774,gene,1,138,BSU_17715
3958,CDS,1905636,1905774,CDS,1,138,yndA
3959,gene,1905808,1906207,gene,1,399,yndA
3960,CDS,1905808,1906207,CDS,1,399,flvS
3961,gene,1906271,1906706,gene,-1,435,flvS
3962,CDS,1906271,1906706,CDS,-1,435,ynzB
3963,gene,1907012,1907201,gene,1,189,ynzB
3964,CDS,1907012,1907201,CDS,1,189,yndD
3965,gene,1907493,1909056,gene,1,1563,yndD
3966,CDS,1907493,1909056,CDS,1,1563,yndE
3968,CDS,1909085,1910177,CDS,1,1092,yndF
3967,gene,1909085,1910177,gene,1,1092,yndE
3969,gene,1910166,1911381,gene,1,1215,yndF
3970,CDS,1910166,1911381,CDS,1,1215,yndG
3971,gene,1911527,1912334,gene,1,807,yndG
3972,CDS,1911527,1912334,CDS,1,807,yndH
3973,gene,1912338,1912956,gene,1,618,yndH
3974,CDS,1912338,1912956,CDS,1,618,yndJ
3975,gene,1912952,1914593,gene,1,1641,yndJ
3976,CDS,1912952,1914593,CDS,1,1641,yndK
3977,gene,1914629,1914995,gene,1,366,yndK
3978,CDS,1914629,1914995,CDS,1,366,surA
3979,gene,1914991,1915272,gene,-1,281,surA
3980,misc_RNA,1914991,1915272,else,-1,281,pghL
3981,gene,1915220,1915979,gene,1,759,pghL
3982,CDS,1915220,1915979,CDS,1,759,yndM
3984,CDS,1916005,1916545,CDS,-1,540,fosB
3983,gene,1916005,1916545,gene,-1,540,yndM
3985,gene,1916662,1917097,gene,1,435,fosB
3986,CDS,1916662,1917097,CDS,1,435,yzzP
3987,gene,1916954,1917302,gene,1,348,yzzP
3988,CDS,1916954,1917302,CDS,1,348,ncrF
3989,gene,1917500,1917580,gene,1,80,ncrF
3990,misc_RNA,1917500,1917580,else,1,80,lexA
3992,CDS,1917638,1918256,CDS,-1,618,dinK
3991,gene,1917638,1918256,gene,-1,618,lexA
3993,gene,1918405,1918723,gene,1,318,dinK
3994,CDS,1918405,1918723,CDS,1,318,dinL
3995,gene,1918741,1919395,gene,1,654,dinL
3996,CDS,1918741,1919395,CDS,1,654,ynzC
3997,gene,1919458,1919692,gene,1,234,ynzC
3998,CDS,1919458,1919692,CDS,1,234,tktA
3999,gene,1919860,1921864,gene,1,2004,tktA
4000,CDS,1919860,1921864,CDS,1,2004,pcfA
4002,CDS,1922016,1922463,CDS,1,447,yneF
4001,gene,1922016,1922463,gene,1,447,pcfA
4003,gene,1922548,1922767,gene,1,219,yneF
4004,CDS,1922548,1922767,CDS,1,219,spo0D
4005,gene,1922840,1923014,gene,-1,174,spo0D
4006,CDS,1922840,1923014,CDS,-1,174,ccdA
4007,gene,1923233,1923941,gene,1,708,ccdA
4008,CDS,1923233,1923941,CDS,1,708,yneI
4010,CDS,1924029,1924392,CDS,1,363,yneJ
4009,gene,1924029,1924392,gene,1,363,yneI
4011,gene,1924470,1924962,gene,1,492,yneJ
4012,CDS,1924470,1924962,CDS,1,492,yneK
4013,gene,1924992,1925421,gene,-1,429,yneK
4014,CDS,1924992,1925421,CDS,-1,429,cotM
4015,gene,1925654,1926047,gene,-1,393,cotM
4016,CDS,1925654,1926047,CDS,-1,393,sspP
4017,gene,1926127,1926274,gene,-1,147,sspP
4018,CDS,1926127,1926274,CDS,-1,147,sspO
4020,CDS,1926305,1926452,CDS,-1,147,citB
4019,gene,1926305,1926452,gene,-1,147,sspO
4021,gene,1926679,1929409,gene,1,2730,citB
4022,CDS,1926679,1929409,CDS,1,2730,yneN
4023,gene,1929480,1929993,gene,1,513,yneN
4024,CDS,1929480,1929993,CDS,1,513,ynzL
4025,gene,1930073,1930199,gene,1,126,ynzL
4026,CDS,1930073,1930199,CDS,1,126,sspN
4027,gene,1930263,1930410,gene,1,147,sspN
4028,CDS,1930263,1930410,CDS,1,147,sspT
4029,gene,1930446,1930698,gene,1,252,sspT
4030,CDS,1930446,1930698,CDS,1,252,yneP
4031,gene,1930833,1931199,gene,1,366,yneP
4032,CDS,1930833,1931199,CDS,1,366,yneQ
4033,gene,1931214,1931514,gene,1,300,yneQ
4034,CDS,1931214,1931514,CDS,1,300,yneR
4036,CDS,1931544,1931832,CDS,-1,288,plsY
4035,gene,1931544,1931832,gene,-1,288,yneR
4038,CDS,1931919,1932501,CDS,-1,582,yneT
4037,gene,1931919,1932501,gene,-1,582,plsY
4039,gene,1932670,1933078,gene,1,408,yneT
4040,CDS,1932670,1933078,CDS,1,408,parE
4041,gene,1933476,1935444,gene,1,1968,parE
4042,CDS,1933476,1935444,CDS,1,1968,parC
4043,gene,1935447,1937868,gene,1,2421,parC
4044,CDS,1935447,1937868,CDS,1,2421,ynfCc
4045,gene,1937914,1938091,gene,-1,177,ynfCc
4046,misc_feature,1937914,1938091,else,-1,177,ynfCn
4047,gene,1938065,1938476,gene,-1,411,ynfCn
4048,misc_feature,1938065,1938476,else,-1,411,alsT
4049,gene,1938924,1940322,gene,1,1398,alsT
4050,CDS,1938924,1940322,CDS,1,1398,eglS
4051,gene,1940624,1942124,gene,1,1500,eglS
4052,CDS,1940624,1942124,CDS,1,1500,ynfE
4054,CDS,1942191,1942455,CDS,1,264,xynC
4053,gene,1942191,1942455,gene,1,264,ynfE
4055,gene,1942713,1943982,gene,-1,1269,xynC
4056,CDS,1942713,1943982,CDS,-1,1269,xynD
4057,gene,1944112,1945654,gene,-1,1542,xynD
4058,CDS,1944112,1945654,CDS,-1,1542,yngA
4059,gene,1946248,1946695,gene,1,447,yngA
4060,CDS,1946248,1946695,CDS,1,447,yngB
4062,CDS,1946701,1947595,CDS,1,894,yngC
4061,gene,1946701,1947595,gene,1,894,yngB
4063,gene,1947667,1948264,gene,1,597,yngC
4064,CDS,1947667,1948264,CDS,1,597,nrnB
4065,gene,1948312,1949512,gene,-1,1200,nrnB
4066,CDS,1948312,1949512,CDS,-1,1200,ldeE
4067,gene,1949681,1951217,gene,-1,1536,ldeE
4068,CDS,1949681,1951217,CDS,-1,1536,ldeF
4069,gene,1951227,1952010,gene,-1,783,ldeF
4070,CDS,1951227,1952010,CDS,-1,783,ldeG
4072,CDS,1952030,1952930,CDS,-1,900,lgeHB
4071,gene,1952030,1952930,gene,-1,900,ldeG
4073,gene,1952944,1953166,gene,-1,222,lgeHB
4074,CDS,1952944,1953166,CDS,-1,222,ldeHA
4075,gene,1953180,1954515,gene,-1,1335,ldeHA
4076,CDS,1953180,1954515,CDS,-1,1335,ldeI
4077,gene,1954524,1956174,gene,-1,1650,ldeI
4078,CDS,1954524,1956174,CDS,-1,1650,ldeJ
4080,CDS,1956217,1957360,CDS,-1,1143,ynzE
4079,gene,1956217,1957360,gene,-1,1143,ldeJ
4081,gene,1957450,1957756,gene,-1,306,ynzE
4082,CDS,1957450,1957756,CDS,-1,306,BSU_18275
4083,gene,1957745,1957919,gene,-1,174,BSU_18275
4084,CDS,1957745,1957919,CDS,-1,174,yngK
4085,gene,1958026,1959559,gene,-1,1533,yngK
4086,CDS,1958026,1959559,CDS,-1,1533,yngL
4087,gene,1959694,1960087,gene,-1,393,yngL
4088,CDS,1959694,1960087,CDS,-1,393,ppsE
4090,CDS,1960197,1964037,CDS,-1,3840,ppsD
4089,gene,1960197,1964037,gene,-1,3840,ppsE
4091,gene,1964044,1974856,gene,-1,10812,ppsD
4092,CDS,1964044,1974856,CDS,-1,10812,ppsC
4093,gene,1974880,1982548,gene,-1,7668,ppsC
4094,CDS,1974880,1982548,CDS,-1,7668,ppsB
4095,gene,1982564,1990247,gene,-1,7683,ppsB
4096,CDS,1982564,1990247,CDS,-1,7683,ppsA
4097,gene,1990271,1997957,gene,-1,7686,ppsA
4098,CDS,1990271,1997957,CDS,-1,7686,dacC
4099,gene,1998339,1999815,gene,-1,1476,dacC
4100,CDS,1998339,1999815,CDS,-1,1476,galM
4101,gene,1999848,2000826,gene,-1,978,galM
4102,CDS,1999848,2000826,CDS,-1,978,yoeA
4103,gene,2000959,2002351,gene,-1,1392,yoeA
4104,CDS,2000959,2002351,CDS,-1,1392,iseA
4105,gene,2002636,2003182,gene,1,546,iseA
4106,CDS,2002636,2003182,CDS,1,546,trnSL-Arg1
4108,tRNA,2003275,2003348,else,-1,73,yoeC
4107,gene,2003275,2003348,gene,-1,73,trnSL-Arg1
4109,gene,2003400,2003946,gene,-1,546,yoeC
4110,CDS,2003400,2003946,CDS,-1,546,yoeD
4111,gene,2004261,2004492,gene,-1,231,yoeD
4112,CDS,2004261,2004492,CDS,-1,231,ggt
4113,gene,2004676,2006440,gene,1,1764,ggt
4114,CDS,2004676,2006440,CDS,1,1764,ftsR
4115,gene,2006540,2007398,gene,-1,858,ftsR
4116,CDS,2006540,2007398,CDS,-1,858,yogA
4117,gene,2007525,2008515,gene,1,990,yogA
4118,CDS,2007525,2008515,CDS,1,990,gltB
4119,gene,2008571,2010053,gene,-1,1482,gltB
4120,CDS,2008571,2010053,CDS,-1,1482,gltA
4121,gene,2010069,2014632,gene,-1,4563,gltA
4122,CDS,2010069,2014632,CDS,-1,4563,gltC
4124,CDS,2014778,2015681,CDS,1,903,proJ
4123,gene,2014778,2015681,gene,1,903,gltC
4125,gene,2015732,2016848,gene,-1,1116,proJ
4126,CDS,2015732,2016848,CDS,-1,1116,proH
4127,gene,2016844,2017738,gene,-1,894,proH
4128,CDS,2016844,2017738,CDS,-1,894,rtp
4129,gene,2017885,2018254,gene,-1,369,rtp
4130,CDS,2017885,2018254,CDS,-1,369,yoxD
4132,CDS,2018553,2019270,CDS,-1,717,yoxC
4131,gene,2018553,2019270,gene,-1,717,yoxD
4133,gene,2019420,2019726,gene,1,306,yoxC
4134,CDS,2019420,2019726,CDS,1,306,yoxB
4135,gene,2019796,2020567,gene,1,771,yoxB
4136,CDS,2019796,2020567,CDS,1,771,yoaA
4137,gene,2020610,2021144,gene,1,534,yoaA
4138,CDS,2020610,2021144,CDS,1,534,yoaB
4139,gene,2021222,2022467,gene,-1,1245,yoaB
4140,CDS,2021222,2022467,CDS,-1,1245,yoaC
4142,CDS,2022560,2024024,CDS,-1,1464,yoaD
4141,gene,2022560,2024024,gene,-1,1464,yoaC
4143,gene,2024041,2025076,gene,-1,1035,yoaD
4144,CDS,2024041,2025076,CDS,-1,1035,mswF
4145,gene,2025159,2025251,gene,-1,92,mswF
4146,misc_RNA,2025159,2025251,else,-1,92,yoaE
4147,gene,2025399,2027442,gene,1,2043,yoaE
4148,CDS,2025399,2027442,CDS,1,2043,yoaF
4150,CDS,2027508,2027802,CDS,1,294,yoaG
4149,gene,2027508,2027802,gene,1,294,yoaF
4151,gene,2028174,2028579,gene,-1,405,yoaG
4152,CDS,2028174,2028579,CDS,-1,405,BSU_18595
4153,gene,2028664,2028784,gene,-1,120,BSU_18595
4154,CDS,2028664,2028784,CDS,-1,120,BSU_18596
4155,gene,2028853,2028976,gene,1,123,BSU_18596
4156,CDS,2028853,2028976,CDS,1,123,yozQ
4157,gene,2029019,2029313,gene,1,294,yozQ
4158,CDS,2029019,2029313,CDS,1,294,yoaH
4160,CDS,2029428,2031114,CDS,-1,1686,yoaI
4159,gene,2029428,2031114,gene,-1,1686,yoaH
4161,gene,2031438,2032890,gene,1,1452,yoaI
4162,CDS,2031438,2032890,CDS,1,1452,exlX
4163,gene,2032926,2033625,gene,-1,699,exlX
4164,CDS,2032926,2033625,CDS,-1,699,yoaK
4165,gene,2033894,2034572,gene,-1,678,yoaK
4166,CDS,2033894,2034572,CDS,-1,678,pelB
4167,gene,2034744,2035782,gene,1,1038,pelB
4168,CDS,2034744,2035782,CDS,1,1038,yoaM
4169,gene,2036038,2036722,gene,1,684,yoaM
4170,CDS,2036038,2036722,CDS,1,684,yozS
4171,gene,2037062,2037368,gene,-1,306,yozS
4172,CDS,2037062,2037368,CDS,-1,306,oxdD
4173,gene,2037600,2038779,gene,-1,1179,oxdD
4174,CDS,2037600,2038779,CDS,-1,1179,yoaO
4176,CDS,2038901,2039390,CDS,-1,489,BSU_18689
4175,gene,2038901,2039390,gene,-1,489,yoaO
4178,CDS,2039414,2039570,CDS,-1,156,yoaP
4177,gene,2039414,2039570,gene,-1,156,BSU_18689
4179,gene,2039609,2040365,gene,-1,756,yoaP
4180,CDS,2039609,2040365,CDS,-1,756,yoaQ
4181,gene,2040672,2041029,gene,1,357,yoaQ
4182,CDS,2040672,2041029,CDS,1,357,yozT
4183,gene,2040987,2041227,gene,-1,240,yozT
4184,CDS,2040987,2041227,CDS,-1,240,yozF
4185,gene,2041329,2041827,gene,-1,498,yozF
4186,CDS,2041329,2041827,CDS,-1,498,yoaR
4187,gene,2041927,2042839,gene,-1,912,yoaR
4188,CDS,2041927,2042839,CDS,-1,912,yoaS
4189,gene,2043185,2043668,gene,1,483,yoaS
4190,CDS,2043185,2043668,CDS,1,483,yozG
4191,gene,2043677,2043932,gene,1,255,yozG
4192,CDS,2043677,2043932,CDS,1,255,yoaT
4194,CDS,2044037,2044832,CDS,1,795,yoaU
4193,gene,2044037,2044832,gene,1,795,yoaT
4195,gene,2044955,2045828,gene,-1,873,yoaU
4196,CDS,2044955,2045828,CDS,-1,873,yoaV
4197,gene,2045928,2046807,gene,1,879,yoaV
4198,CDS,2045928,2046807,CDS,1,879,yoaW
4199,gene,2046979,2047411,gene,-1,432,yoaW
4200,CDS,2046979,2047411,CDS,-1,432,yoaZ
4202,CDS,2047674,2048307,CDS,-1,633,penP
4201,gene,2047674,2048307,gene,-1,633,yoaZ
4203,gene,2048532,2049453,gene,1,921,penP
4204,CDS,2048532,2049453,CDS,1,921,yobA
4205,gene,2049949,2050312,gene,-1,363,yobA
4206,CDS,2049949,2050312,CDS,-1,363,yozU
4207,gene,2050372,2050585,gene,-1,213,yozU
4208,misc_feature,2050372,2050585,else,-1,213,yobB
4209,gene,2050688,2050952,gene,1,264,yobB
4210,CDS,2050688,2050952,CDS,1,264,yppS
4212,CDS,2051328,2053929,CDS,-1,2601,xynA
4211,gene,2051328,2053929,gene,-1,2601,yppS
4213,gene,2054598,2055240,gene,-1,642,xynA
4214,CDS,2054598,2055240,CDS,-1,642,yozV
4215,gene,2055867,2056107,gene,-1,240,yozV
4216,CDS,2055867,2056107,CDS,-1,240,yobD
4217,gene,2056277,2056616,gene,1,339,yobD
4218,CDS,2056277,2056616,CDS,1,339,yozH
4220,CDS,2056649,2057006,CDS,-1,357,yozI
4219,gene,2056649,2057006,gene,-1,357,yozH
4221,gene,2057213,2057579,gene,1,366,yozI
4222,CDS,2057213,2057579,CDS,1,366,yobE
4223,gene,2057800,2058460,gene,1,660,yobE
4224,CDS,2057800,2058460,CDS,1,660,yobF
4225,gene,2058714,2059638,gene,-1,924,yobF
4226,CDS,2058714,2059638,CDS,-1,924,yozW
4227,gene,2059690,2059864,gene,-1,174,yozW
4228,CDS,2059690,2059864,CDS,-1,174,yozX
4230,CDS,2060008,2060233,CDS,1,225,yozJ
4229,gene,2060008,2060233,gene,1,225,yozX
4231,gene,2060236,2060692,gene,-1,456,yozJ
4232,CDS,2060236,2060692,CDS,-1,456,yozY
4233,gene,2060816,2061077,gene,1,261,yozY
4234,CDS,2060816,2061077,CDS,1,261,yozZ
4235,gene,2061854,2061995,gene,1,141,yozZ
4236,misc_feature,2061854,2061995,else,1,141,rapK
4237,gene,2062149,2063265,gene,1,1116,rapK
4238,CDS,2062149,2063265,CDS,1,1116,phrK
4239,gene,2063261,2063384,gene,1,123,phrK
4240,CDS,2063261,2063384,CDS,1,123,yobHc
4241,gene,2063509,2064163,gene,-1,654,yobHc
4242,misc_feature,2063509,2064163,else,-1,654,yobHm
4243,gene,2064199,2064547,gene,-1,348,yobHm
4244,misc_feature,2064199,2064547,else,-1,348,yozL
4245,gene,2064539,2064833,gene,-1,294,yozL
4246,CDS,2064539,2064833,CDS,-1,294,yozM
4248,CDS,2065041,2065377,CDS,1,336,yobI
4247,gene,2065041,2065377,gene,1,336,yozM
4250,CDS,2065423,2069029,CDS,-1,3606,yoyA
4249,gene,2065423,2069029,gene,-1,3606,yobI
4251,gene,2069261,2069561,gene,-1,300,yoyA
4252,misc_feature,2069261,2069561,else,-1,300,asrE
4253,gene,2069731,2070115,gene,-1,384,asrE
4254,misc_RNA,2069731,2070115,else,-1,384,bsrE
4255,gene,2069882,2069975,gene,1,93,bsrE
4256,CDS,2069882,2069975,CDS,1,93,yobJ
4257,gene,2070243,2071086,gene,-1,843,yobJ
4258,CDS,2070243,2071086,CDS,-1,843,rttM
4260,CDS,2071285,2071744,CDS,-1,459,rttL
4259,gene,2071285,2071744,gene,-1,459,rttM
4261,gene,2071753,2073556,gene,-1,1803,rttL
4262,CDS,2071753,2073556,CDS,-1,1803,yobM
4263,gene,2073657,2074215,gene,-1,558,yobM
4264,CDS,2073657,2074215,CDS,-1,558,yobN
4265,gene,2074342,2075779,gene,1,1437,yobN
4266,CDS,2074342,2075779,CDS,1,1437,yobO
4268,CDS,2076205,2078626,CDS,1,2421,bsrF
4267,gene,2076205,2078626,gene,1,2421,yobO
4269,gene,2079095,2079203,gene,1,108,bsrF
4270,misc_RNA,2079095,2079203,else,1,108,csaA
4271,gene,2079213,2079546,gene,-1,333,csaA
4272,CDS,2079213,2079546,CDS,-1,333,yobQ
4273,gene,2079610,2080336,gene,-1,726,yobQ
4274,CDS,2079610,2080336,CDS,-1,726,yobR
4275,gene,2080350,2081094,gene,-1,744,yobR
4276,CDS,2080350,2081094,CDS,-1,744,yobS
4277,gene,2081171,2081747,gene,-1,576,yobS
4278,CDS,2081171,2081747,CDS,-1,576,yobT
4279,gene,2081752,2082454,gene,-1,702,yobT
4280,CDS,2081752,2082454,CDS,-1,702,yobU
4281,gene,2082530,2083013,gene,-1,483,yobU
4282,CDS,2082530,2083013,CDS,-1,483,yobV
4283,gene,2083066,2084008,gene,-1,942,yobV
4284,CDS,2083066,2084008,CDS,-1,942,yobW
4286,CDS,2084213,2084759,CDS,1,546,czrA
4285,gene,2084213,2084759,gene,1,546,yobW
4287,gene,2084785,2085109,gene,-1,324,czrA
4288,CDS,2084785,2085109,CDS,-1,324,yocA
4289,gene,2085302,2085980,gene,1,678,yocA
4290,CDS,2085302,2085980,CDS,1,678,yozB
4291,gene,2086069,2086606,gene,-1,537,yozB
4292,CDS,2086069,2086606,CDS,-1,537,yocB
4294,CDS,2086742,2087525,CDS,-1,783,yocC
4293,gene,2086742,2087525,gene,-1,783,yocB
4295,gene,2087695,2088193,gene,1,498,yocC
4296,CDS,2087695,2088193,CDS,1,498,yocD
4297,gene,2088256,2089234,gene,1,978,yocD
4298,CDS,2088256,2089234,CDS,1,978,desE
4299,gene,2089395,2090454,gene,1,1059,desE
4300,CDS,2089395,2090454,CDS,1,1059,desK
4301,gene,2090573,2091686,gene,1,1113,desK
4302,CDS,2090573,2091686,CDS,1,1113,desR
4304,CDS,2091704,2092304,CDS,1,600,walL
4303,gene,2091704,2092304,gene,1,600,desR
4305,gene,2092898,2093762,gene,-1,864,walL
4306,CDS,2092898,2093762,CDS,-1,864,recQ
4307,gene,2094009,2095785,gene,-1,1776,recQ
4308,CDS,2094009,2095785,CDS,-1,1776,ssrSA
4309,gene,2095908,2096111,gene,-1,203,ssrSA
4310,misc_RNA,2095908,2096111,else,-1,203,azoJ
4311,gene,2096349,2096976,gene,-1,627,azoJ
4312,CDS,2096349,2096976,CDS,-1,627,yocK
4313,gene,2097125,2097617,gene,-1,492,yocK
4314,CDS,2097125,2097617,CDS,-1,492,yocL
4315,gene,2097691,2098024,gene,-1,333,yocL
4316,CDS,2097691,2098024,CDS,-1,333,yoyB
4317,gene,2098101,2098329,gene,1,228,yoyB
4318,CDS,2098101,2098329,CDS,1,228,yocM
4320,CDS,2098315,2098792,CDS,-1,477,yozN
4319,gene,2098315,2098792,gene,-1,477,yocM
4322,CDS,2098858,2099122,CDS,1,264,yocN
4321,gene,2098858,2099122,gene,1,264,yozN
4323,gene,2099126,2099360,gene,1,234,yocN
4324,CDS,2099126,2099360,CDS,1,234,yozO
4325,gene,2099445,2099790,gene,-1,345,yozO
4326,CDS,2099445,2099790,CDS,-1,345,yozC
4327,gene,2100146,2100350,gene,-1,204,yozC
4328,CDS,2100146,2100350,CDS,-1,204,dhaS
4329,gene,2100579,2102067,gene,1,1488,dhaS
4330,CDS,2100579,2102067,CDS,1,1488,sqhC
4331,gene,2102167,2104066,gene,1,1899,sqhC
4332,CDS,2102167,2104066,CDS,1,1899,sodF
4333,gene,2104055,2104901,gene,1,846,sodF
4334,CDS,2104055,2104901,CDS,1,846,yocR
4335,gene,2104933,2106271,gene,-1,1338,yocR
4336,CDS,2104933,2106271,CDS,-1,1338,yocS
4337,gene,2106489,2107455,gene,1,966,yocS
4338,CDS,2106489,2107455,CDS,1,966,odhB
4340,CDS,2107504,2108758,CDS,-1,1254,odhA
4339,gene,2107504,2108758,gene,-1,1254,odhB
4341,gene,2108773,2111608,gene,-1,2835,odhA
4342,CDS,2108773,2111608,CDS,-1,2835,yojO
4343,gene,2111836,2113753,gene,-1,1917,yojO
4344,CDS,2111836,2113753,CDS,-1,1917,yojN
4345,gene,2113763,2114678,gene,-1,915,yojN
4346,CDS,2113763,2114678,CDS,-1,915,sodC
4348,CDS,2114741,2115332,CDS,-1,591,cwlS
4347,gene,2114741,2115332,gene,-1,591,sodC
4349,gene,2115424,2116669,gene,-1,1245,cwlS
4350,CDS,2115424,2116669,CDS,-1,1245,yojK
4351,gene,2117050,2118268,gene,-1,1218,yojK
4352,CDS,2117050,2118268,CDS,-1,1218,cdaS
4353,gene,2118503,2119127,gene,-1,624,cdaS
4354,CDS,2118503,2119127,CDS,-1,624,mdtK
4356,CDS,2119392,2120751,CDS,1,1359,rsbRC
4355,gene,2119392,2120751,gene,1,1359,mdtK
4358,CDS,2120766,2121615,CDS,1,849,bshBB
4357,gene,2120766,2121615,gene,1,849,rsbRC
4359,gene,2121640,2122306,gene,-1,666,bshBB
4360,CDS,2121640,2122306,CDS,-1,666,yojF
4361,gene,2122324,2122675,gene,-1,351,yojF
4362,CDS,2122324,2122675,CDS,-1,351,yoyC
4363,gene,2122671,2122950,gene,-1,279,yoyC
4364,CDS,2122671,2122950,CDS,-1,279,yojE
4365,gene,2123025,2123922,gene,-1,897,yojE
4366,CDS,2123025,2123922,CDS,-1,897,gerT
4368,CDS,2124020,2124494,CDS,1,474,yojB
4367,gene,2124020,2124494,gene,1,474,gerT
4369,gene,2124528,2124765,gene,-1,237,yojB
4370,CDS,2124528,2124765,CDS,-1,237,yojA
4371,gene,2124849,2126184,gene,-1,1335,yojA
4372,CDS,2124849,2126184,CDS,-1,1335,yodA
4373,gene,2126548,2126938,gene,1,390,yodA
4374,CDS,2126548,2126938,CDS,1,390,arxR
4376,CDS,2127344,2127683,CDS,-1,339,noxC
4375,gene,2127344,2127683,gene,-1,339,arxR
4377,gene,2127812,2128421,gene,1,609,noxC
4378,CDS,2127812,2128421,CDS,1,609,yodD
4379,gene,2128463,2129066,gene,-1,603,yodD
4380,CDS,2128463,2129066,CDS,-1,603,yodE
4381,gene,2129081,2129993,gene,-1,912,yodE
4382,CDS,2129081,2129993,CDS,-1,912,yoyD
4383,gene,2130176,2130377,gene,1,201,yoyD
4384,CDS,2130176,2130377,CDS,1,201,yodF
4385,gene,2130376,2131867,gene,1,1491,yodF
4386,CDS,2130376,2131867,CDS,1,1491,ctpA
4387,gene,2131901,2133302,gene,-1,1401,ctpA
4388,CDS,2131901,2133302,CDS,-1,1401,yodH
4389,gene,2133454,2134156,gene,1,702,yodH
4390,CDS,2133454,2134156,CDS,1,702,yodI
4392,CDS,2134243,2134495,CDS,1,252,ldcB
4391,gene,2134243,2134495,gene,1,252,yodI
4393,gene,2134565,2135387,gene,-1,822,ldcB
4394,CDS,2134565,2135387,CDS,-1,822,deoD
4395,gene,2135469,2136171,gene,-1,702,deoD
4396,CDS,2135469,2136171,CDS,-1,702,yoyE
4397,gene,2136372,2136498,gene,1,126,yoyE
4398,CDS,2136372,2136498,CDS,1,126,yodL
4399,gene,2136537,2136852,gene,-1,315,yodL
4400,CDS,2136537,2136852,CDS,-1,315,pgpB
4401,gene,2136912,2137524,gene,-1,612,pgpB
4402,CDS,2136912,2137524,CDS,-1,612,yozD
4403,gene,2137601,2137778,gene,-1,177,yozD
4404,CDS,2137601,2137778,CDS,-1,177,yoyF
4405,gene,2137896,2138040,gene,1,144,yoyF
4406,CDS,2137896,2138040,CDS,1,144,yodN
4408,CDS,2138036,2138717,CDS,-1,681,yozE
4407,gene,2138036,2138717,gene,-1,681,yodN
4409,gene,2138867,2139092,gene,-1,225,yozE
4410,CDS,2138867,2139092,CDS,-1,225,yokU
4411,gene,2139178,2139457,gene,-1,279,yokU
4412,CDS,2139178,2139457,CDS,-1,279,kamA
4413,gene,2139453,2140869,gene,-1,1416,kamA
4414,CDS,2139453,2140869,CDS,-1,1416,kamB
4416,CDS,2140897,2141725,CDS,-1,828,yodQ
4415,gene,2140897,2141725,gene,-1,828,kamB
4417,gene,2141702,2143013,gene,-1,1311,yodQ
4418,CDS,2141702,2143013,CDS,-1,1311,yodR
4419,gene,2143021,2143675,gene,-1,654,yodR
4420,CDS,2143021,2143675,CDS,-1,654,yodS
4421,gene,2143659,2144349,gene,-1,690,yodS
4422,CDS,2143659,2144349,CDS,-1,690,yodT
4423,gene,2144355,2145690,gene,-1,1335,yodT
4424,CDS,2144355,2145690,CDS,-1,1335,BSU_19745
4426,CDS,2145670,2145826,CDS,-1,156,yoyG
4425,gene,2145670,2145826,gene,-1,156,BSU_19745
4427,gene,2145819,2146053,gene,-1,234,yoyG
4428,CDS,2145819,2146053,CDS,-1,234,cgeE
4429,gene,2146012,2146792,gene,-1,780,cgeE
4430,CDS,2146012,2146792,CDS,-1,780,cgeD
4431,gene,2146820,2148101,gene,-1,1281,cgeD
4432,CDS,2146820,2148101,CDS,-1,1281,cgeC
4434,CDS,2148165,2148471,CDS,-1,306,cgeA
4433,gene,2148165,2148471,gene,-1,306,cgeC
4435,gene,2148675,2149077,gene,1,402,cgeA
4436,CDS,2148675,2149077,CDS,1,402,cgeB
4437,gene,2149083,2150037,gene,1,954,cgeB
4438,CDS,2149083,2150037,CDS,1,954,phyC
4439,gene,2150107,2151256,gene,-1,1149,phyC
4440,CDS,2150107,2151256,CDS,-1,1149,spsMn
4441,gene,2151625,2152045,gene,1,420,spsMn
4442,misc_feature,2151625,2152045,else,1,420,sprB
4444,CDS,2152085,2152262,CDS,-1,177,yotM
4443,gene,2152085,2152262,gene,-1,177,sprB
4445,gene,2152264,2152852,gene,-1,588,yotM
4446,CDS,2152264,2152852,CDS,-1,588,yotL
4447,gene,2152926,2153169,gene,1,243,yotL
4448,CDS,2152926,2153169,CDS,1,243,yotK
4449,gene,2153170,2153356,gene,-1,186,yotK
4450,CDS,2153170,2153356,CDS,-1,186,yotJ
4451,gene,2153439,2153652,gene,-1,213,yotJ
4452,CDS,2153439,2153652,CDS,-1,213,yotI
4453,gene,2153717,2154080,gene,-1,363,yotI
4454,CDS,2153717,2154080,CDS,-1,363,yotH
4455,gene,2154076,2154250,gene,-1,174,yotH
4456,CDS,2154076,2154250,CDS,-1,174,yotG
4457,gene,2154265,2154583,gene,-1,318,yotG
4458,CDS,2154265,2154583,CDS,-1,318,yotF
4459,gene,2154595,2154673,gene,-1,78,yotF
4460,CDS,2154595,2154673,CDS,-1,78,yotE
4462,CDS,2154704,2154851,CDS,-1,147,BSU_19915
4461,gene,2154704,2154851,gene,-1,147,yotE
4463,gene,2154780,2154972,gene,1,192,BSU_19915
4464,CDS,2154780,2154972,CDS,1,192,yotD
4465,gene,2154886,2155018,gene,-1,132,yotD
4466,CDS,2154886,2155018,CDS,-1,132,yotC
4467,gene,2155057,2155249,gene,-1,192,yotC
4468,CDS,2155057,2155249,CDS,-1,192,yotB
4469,gene,2155292,2156120,gene,-1,828,yotB
4470,CDS,2155292,2156120,CDS,-1,828,sspC
4471,gene,2156238,2156457,gene,1,219,sspC
4472,CDS,2156238,2156457,CDS,1,219,yosX
4473,gene,2156756,2157110,gene,-1,354,yosX
4474,CDS,2156756,2157110,CDS,-1,354,yosW
4475,gene,2157340,2157682,gene,-1,342,yosW
4476,CDS,2157340,2157682,CDS,-1,342,yosV
4478,CDS,2157828,2158119,CDS,-1,291,yojW
4477,gene,2157828,2158119,gene,-1,291,yosV
4479,gene,2158119,2158287,gene,-1,168,yojW
4480,CDS,2158119,2158287,CDS,-1,168,yosU
4481,gene,2158438,2158684,gene,1,246,yosU
4482,CDS,2158438,2158684,CDS,1,246,yosT
4483,gene,2158723,2159173,gene,-1,450,yosT
4484,CDS,2158723,2159173,CDS,-1,450,dutB
4486,CDS,2159267,2159696,CDS,-1,429,yosR
4485,gene,2159267,2159696,gene,-1,429,dutB
4487,gene,2159741,2159984,gene,-1,243,yosR
4488,misc_feature,2159741,2159984,else,-1,243,nrdFB
4489,gene,2159980,2161778,gene,-1,1798,nrdFB
4490,CDS,2159980,2161778,CDS,-1,1798,srdFi
4491,gene,2160389,2161194,gene,-1,805,srdFi
4492,misc_RNA,2160389,2161194,else,-1,805,yosQ
4494,CDS,2160564,2161086,CDS,-1,522,nrdEB
4493,gene,2160564,2161086,gene,-1,522,yosQ
4496,CDS,2162107,2165614,CDS,-1,3507,nrdEB
4495,gene,2162107,2165614,gene,-1,3507,nrdEB
4497,misc_feature,2163067,2164222,else,-1,1155,srdEi
4498,gene,2164642,2164894,gene,-1,252,srdEi
4499,misc_RNA,2164642,2164894,else,-1,252,nrdIB
4500,gene,2165576,2165972,gene,-1,396,nrdIB
4501,CDS,2165576,2165972,CDS,-1,396,yosL
4502,gene,2165971,2166325,gene,-1,354,yosL
4503,CDS,2165971,2166325,CDS,-1,354,yosK
4504,gene,2166412,2166613,gene,-1,201,yosK
4505,CDS,2166412,2166613,CDS,-1,201,yosJ
4506,gene,2166657,2166852,gene,-1,195,yosJ
4507,CDS,2166657,2166852,CDS,-1,195,yosI
4508,gene,2166872,2167007,gene,-1,135,yosI
4509,CDS,2166872,2167007,CDS,-1,135,yosH
4510,gene,2167038,2167509,gene,-1,471,yosH
4511,CDS,2167038,2167509,CDS,-1,471,yosG
4513,CDS,2167569,2167932,CDS,-1,363,yosF
4512,gene,2167569,2167932,gene,-1,363,yosG
4514,gene,2167974,2168100,gene,-1,126,yosF
4515,CDS,2167974,2168100,CDS,-1,126,yosE
4516,gene,2168113,2168461,gene,-1,348,yosE
4517,CDS,2168113,2168461,CDS,-1,348,yosD
4518,gene,2168475,2168871,gene,-1,396,yosD
4519,CDS,2168475,2168871,CDS,-1,396,yosC
4521,CDS,2168909,2169452,CDS,-1,543,yosB
4520,gene,2168909,2169452,gene,-1,543,yosC
4522,gene,2169496,2169676,gene,-1,180,yosB
4523,CDS,2169496,2169676,CDS,-1,180,yosA
4524,gene,2169806,2169926,gene,1,120,yosA
4525,CDS,2169806,2169926,CDS,1,120,yorZ
4526,gene,2170029,2170242,gene,-1,213,yorZ
4527,CDS,2170029,2170242,CDS,-1,213,yorY
4528,gene,2170308,2170491,gene,-1,183,yorY
4529,CDS,2170308,2170491,CDS,-1,183,yorX
4530,gene,2170503,2170731,gene,-1,228,yorX
4531,CDS,2170503,2170731,CDS,-1,228,yorW
4532,gene,2170770,2171136,gene,-1,366,yorW
4533,CDS,2170770,2171136,CDS,-1,366,yorV
4534,gene,2171138,2171357,gene,-1,219,yorV
4535,CDS,2171138,2171357,CDS,-1,219,mtbP
4537,CDS,2171400,2172732,CDS,-1,1332,yorT
4536,gene,2171400,2172732,gene,-1,1332,mtbP
4538,gene,2172780,2172900,gene,-1,120,yorT
4539,CDS,2172780,2172900,CDS,-1,120,yorS
4540,gene,2172931,2173450,gene,-1,519,yorS
4541,CDS,2172931,2173450,CDS,-1,519,yorR
4542,gene,2173458,2173956,gene,-1,498,yorR
4543,CDS,2173458,2173956,CDS,-1,498,yorQ
4544,gene,2173955,2174111,gene,-1,156,yorQ
4545,CDS,2173955,2174111,CDS,-1,156,yorP
4546,gene,2174103,2174319,gene,-1,216,yorP
4547,CDS,2174103,2174319,CDS,-1,216,yorO
4548,gene,2174351,2174549,gene,-1,198,yorO
4549,CDS,2174351,2174549,CDS,-1,198,yorN
4550,gene,2174584,2174734,gene,-1,150,yorN
4551,CDS,2174584,2174734,CDS,-1,150,yorM
4553,CDS,2174851,2175568,CDS,-1,717,dpoL
4552,gene,2174851,2175568,gene,-1,717,yorM
4554,gene,2175595,2179513,gene,-1,3918,dpoL
4555,CDS,2175595,2179513,CDS,-1,3918,yorK
4556,gene,2179525,2181256,gene,-1,1731,yorK
4557,CDS,2179525,2181256,CDS,-1,1731,yorJ
4558,gene,2181255,2182392,gene,-1,1137,yorJ
4559,CDS,2181255,2182392,CDS,-1,1137,yorI
4561,CDS,2182407,2183922,CDS,-1,1515,yorH
4560,gene,2182407,2183922,gene,-1,1515,yorI
4562,gene,2183936,2184407,gene,-1,471,yorH
4563,CDS,2183936,2184407,CDS,-1,471,yorG
4564,gene,2184449,2185421,gene,-1,972,yorG
4565,CDS,2184449,2185421,CDS,-1,972,yorF
4566,gene,2185503,2186418,gene,-1,915,yorF
4567,CDS,2185503,2186418,CDS,-1,915,yorE
4568,gene,2186439,2186811,gene,-1,372,yorE
4569,CDS,2186439,2186811,CDS,-1,372,yorD
4571,CDS,2186984,2187299,CDS,-1,315,yorC
4570,gene,2186984,2187299,gene,-1,315,yorD
4572,gene,2187375,2187756,gene,-1,381,yorC
4573,CDS,2187375,2187756,CDS,-1,381,yorB
4574,gene,2187818,2188115,gene,-1,297,yorB
4575,CDS,2187818,2188115,CDS,-1,297,yorA
4576,gene,2188203,2189964,gene,-1,1761,yorA
4577,CDS,2188203,2189964,CDS,-1,1761,pghZ
4579,CDS,2189960,2190785,CDS,-1,825,yoqY
4578,gene,2189960,2190785,gene,-1,825,pghZ
4580,gene,2190883,2191279,gene,-1,396,yoqY
4581,CDS,2190883,2191279,CDS,-1,396,yoqX
4582,gene,2191333,2191555,gene,-1,222,yoqX
4583,CDS,2191333,2191555,CDS,-1,222,yoqW
4584,gene,2191625,2192300,gene,1,675,yoqW
4585,CDS,2191625,2192300,CDS,1,675,yoqV
4586,gene,2192369,2193182,gene,1,813,yoqV
4587,CDS,2192369,2193182,CDS,1,813,yoqU
4589,CDS,2193247,2193661,CDS,-1,414,yoqT
4588,gene,2193247,2193661,gene,-1,414,yoqU
4590,gene,2193826,2193976,gene,1,150,yoqT
4591,CDS,2193826,2193976,CDS,1,150,yoqS
4592,gene,2194052,2194400,gene,-1,348,yoqS
4593,CDS,2194052,2194400,CDS,-1,348,yoqR
4594,gene,2194401,2194758,gene,-1,357,yoqR
4595,CDS,2194401,2194758,CDS,-1,357,yoqP
4596,gene,2194717,2195059,gene,-1,342,yoqP
4597,CDS,2194717,2195059,CDS,-1,342,yoqO
4598,gene,2195172,2195547,gene,1,375,yoqO
4599,CDS,2195172,2195547,CDS,1,375,yoqN
4600,gene,2195563,2195782,gene,-1,219,yoqN
4601,CDS,2195563,2195782,CDS,-1,219,yoqM
4602,gene,2195985,2196264,gene,1,279,yoqM
4603,CDS,2195985,2196264,CDS,1,279,yoqL
4605,CDS,2196388,2197081,CDS,-1,693,yoqK
4604,gene,2196388,2197081,gene,-1,693,yoqL
4607,CDS,2197120,2197324,CDS,-1,204,yoqJ
4606,gene,2197120,2197324,gene,-1,204,yoqK
4608,gene,2197343,2197859,gene,-1,516,yoqJ
4609,CDS,2197343,2197859,CDS,-1,516,yoqI
4610,gene,2198069,2198264,gene,-1,195,yoqI
4611,CDS,2198069,2198264,CDS,-1,195,yoqH
4612,gene,2198312,2198765,gene,-1,453,yoqH
4613,CDS,2198312,2198765,CDS,-1,453,yoqG
4614,gene,2198847,2199105,gene,-1,258,yoqG
4615,CDS,2198847,2199105,CDS,-1,258,yoqF
4616,gene,2199149,2199353,gene,-1,204,yoqF
4617,CDS,2199149,2199353,CDS,-1,204,yoqE
4618,gene,2199361,2199526,gene,-1,165,yoqE
4619,CDS,2199361,2199526,CDS,-1,165,yoqD
4620,gene,2199579,2200335,gene,-1,756,yoqD
4621,CDS,2199579,2200335,CDS,-1,756,yoqC
4623,CDS,2200375,2200783,CDS,-1,408,yoqB
4622,gene,2200375,2200783,gene,-1,408,yoqC
4624,gene,2200789,2201128,gene,-1,339,yoqB
4625,CDS,2200789,2201128,CDS,-1,339,yoqA
4626,gene,2201124,2201475,gene,-1,351,yoqA
4627,CDS,2201124,2201475,CDS,-1,351,yopZ
4628,gene,2201487,2201691,gene,-1,204,yopZ
4629,CDS,2201487,2201691,CDS,-1,204,yopY
4631,CDS,2201704,2201983,CDS,-1,279,yopX
4630,gene,2201704,2201983,gene,-1,279,yopY
4632,gene,2201979,2202384,gene,-1,405,yopX
4633,CDS,2201979,2202384,CDS,-1,405,yopW
4634,gene,2202380,2202716,gene,-1,336,yopW
4635,CDS,2202380,2202716,CDS,-1,336,yopV
4636,gene,2202804,2202999,gene,-1,195,yopV
4637,CDS,2202804,2202999,CDS,-1,195,yopU
4638,gene,2203110,2203308,gene,-1,198,yopU
4639,CDS,2203110,2203308,CDS,-1,198,yopT
4641,CDS,2203377,2203596,CDS,-1,219,yopS
4640,gene,2203377,2203596,gene,-1,219,yopT
4642,gene,2203778,2204003,gene,1,225,yopS
4643,CDS,2203778,2204003,CDS,1,225,yopR
4644,gene,2204191,2205169,gene,-1,978,yopR
4645,CDS,2204191,2205169,CDS,-1,978,yopQ
4646,gene,2205192,2206575,gene,-1,1383,yopQ
4647,CDS,2205192,2206575,CDS,-1,1383,yopP
4649,CDS,2206681,2207758,CDS,-1,1077,yopO
4648,gene,2206681,2207758,gene,-1,1077,yopP
4650,gene,2207747,2207960,gene,-1,213,yopO
4651,CDS,2207747,2207960,CDS,-1,213,yopN
4652,gene,2208007,2208325,gene,-1,318,yopN
4653,CDS,2208007,2208325,CDS,-1,318,yopM
4654,gene,2208327,2208528,gene,-1,201,yopM
4655,CDS,2208327,2208528,CDS,-1,201,aimX
4656,gene,2208589,2208880,gene,-1,291,aimX
4657,ncRNA,2208589,2208880,else,-1,291,aimP
4659,CDS,2208854,2208980,CDS,-1,126,aimR
4658,gene,2208854,2208980,gene,-1,126,aimP
4660,gene,2208993,2210154,gene,-1,1161,aimR
4661,CDS,2208993,2210154,CDS,-1,1161,yopJ
4662,gene,2210330,2210747,gene,-1,417,yopJ
4663,CDS,2210330,2210747,CDS,-1,417,yopI
4664,gene,2210748,2211282,gene,-1,534,yopI
4665,CDS,2210748,2211282,CDS,-1,534,sieB
4666,gene,2211308,2211845,gene,-1,537,sieB
4667,CDS,2211308,2211845,CDS,-1,537,yopG
4668,gene,2211883,2212015,gene,-1,132,yopG
4669,CDS,2211883,2212015,CDS,-1,132,yopF
4670,gene,2212025,2212241,gene,-1,216,yopF
4671,CDS,2212025,2212241,CDS,-1,216,yopE
4672,gene,2212244,2212496,gene,-1,252,yopE
4673,CDS,2212244,2212496,CDS,-1,252,yoyH
4674,gene,2212566,2212746,gene,1,180,yoyH
4675,CDS,2212566,2212746,CDS,1,180,yoyI
4677,CDS,2212847,2213078,CDS,1,231,yopD
4676,gene,2212847,2213078,gene,1,231,yoyI
4678,gene,2213082,2213478,gene,-1,396,yopD
4679,CDS,2213082,2213478,CDS,-1,396,yopC
4680,gene,2213535,2214864,gene,-1,1329,yopC
4681,CDS,2213535,2214864,CDS,-1,1329,yopB
4682,gene,2214971,2215199,gene,-1,228,yopB
4683,CDS,2214971,2215199,CDS,-1,228,yopA
4684,gene,2215459,2216776,gene,-1,1317,yopA
4685,CDS,2215459,2216776,CDS,-1,1317,yonX
4686,gene,2217132,2217639,gene,-1,507,yonX
4687,CDS,2217132,2217639,CDS,-1,507,yonV
4688,gene,2217966,2219199,gene,-1,1233,yonV
4689,CDS,2217966,2219199,CDS,-1,1233,yonU
4690,gene,2219280,2219469,gene,-1,189,yonU
4691,CDS,2219280,2219469,CDS,-1,189,yoyJ
4693,CDS,2219513,2219765,CDS,-1,252,apbT
4692,gene,2219513,2219765,gene,-1,252,yoyJ
4694,gene,2219742,2219849,gene,1,107,apbT
4695,misc_RNA,2219742,2219849,else,1,107,spbT
4696,gene,2219783,2219960,gene,-1,177,spbT
4697,CDS,2219783,2219960,CDS,-1,177,yonS
4698,gene,2220334,2220946,gene,-1,612,yonS
4699,CDS,2220334,2220946,CDS,-1,612,yonR
4701,CDS,2221060,2221387,CDS,-1,327,yonP
4700,gene,2221060,2221387,gene,-1,327,yonR
4702,gene,2222339,2222534,gene,1,195,yonP
4703,CDS,2222339,2222534,CDS,1,195,yonO
4704,gene,2222573,2225093,gene,1,2520,yonO
4705,CDS,2222573,2225093,CDS,1,2520,hupN
4706,gene,2225336,2225615,gene,1,279,hupN
4707,CDS,2225336,2225615,CDS,1,279,BSU_21058
4708,gene,2226175,2226346,gene,1,171,BSU_21058
4709,CDS,2226175,2226346,CDS,1,171,yonK
4711,CDS,2227296,2227488,CDS,1,192,yonJ
4710,gene,2227296,2227488,gene,1,192,yonK
4712,gene,2227504,2228722,gene,1,1218,yonJ
4713,CDS,2227504,2228722,CDS,1,1218,yonI
4714,gene,2228755,2229166,gene,-1,411,yonI
4715,CDS,2228755,2229166,CDS,-1,411,yonH
4716,gene,2229384,2229885,gene,1,501,yonH
4717,CDS,2229384,2229885,CDS,1,501,yonG
4719,CDS,2229987,2230908,CDS,1,921,yonF
4718,gene,2229987,2230908,gene,1,921,yonG
4720,gene,2230894,2232664,gene,1,1770,yonF
4721,CDS,2230894,2232664,CDS,1,1770,yonE
4722,gene,2232681,2234202,gene,1,1521,yonE
4723,CDS,2232681,2234202,CDS,1,1521,yonD
4724,gene,2234232,2235669,gene,1,1437,yonD
4725,CDS,2234232,2235669,CDS,1,1437,yonC
4726,gene,2235693,2236230,gene,1,537,yonC
4727,CDS,2235693,2236230,CDS,1,537,yonB
4729,CDS,2236268,2237285,CDS,1,1017,yonA
4728,gene,2236268,2237285,gene,1,1017,yonB
4730,gene,2237320,2237791,gene,1,471,yonA
4731,CDS,2237320,2237791,CDS,1,471,yomZ
4732,gene,2237805,2238201,gene,1,396,yomZ
4733,CDS,2237805,2238201,CDS,1,396,yomY
4734,gene,2238197,2238452,gene,1,255,yomY
4735,CDS,2238197,2238452,CDS,1,255,yomX
4736,gene,2238435,2239086,gene,1,651,yomX
4737,CDS,2238435,2239086,CDS,1,651,yomW
4738,gene,2239082,2239589,gene,1,507,yomW
4739,CDS,2239082,2239589,CDS,1,507,yomV
4740,gene,2239585,2240296,gene,1,711,yomV
4741,CDS,2239585,2240296,CDS,1,711,yomU
4742,gene,2240338,2241136,gene,1,798,yomU
4743,CDS,2240338,2241136,CDS,1,798,youA
4745,CDS,2241153,2241765,CDS,1,612,yomT
4744,gene,2241153,2241765,gene,1,612,youA
4747,CDS,2241764,2241992,CDS,1,228,yomS
4746,gene,2241764,2241992,gene,1,228,yomT
4748,gene,2242055,2242412,gene,1,357,yomS
4749,CDS,2242055,2242412,CDS,1,357,yomR
4750,gene,2242413,2243631,gene,1,1218,yomR
4751,CDS,2242413,2243631,CDS,1,1218,yomQ
4752,gene,2243641,2243992,gene,1,351,yomQ
4753,CDS,2243641,2243992,CDS,1,351,yomP
4754,gene,2243988,2244180,gene,1,192,yomP
4755,CDS,2243988,2244180,CDS,1,192,yomO
4756,gene,2244229,2244730,gene,1,501,yomO
4757,CDS,2244229,2244730,CDS,1,501,yomN
4758,gene,2244713,2245133,gene,1,420,yomN
4759,CDS,2244713,2245133,CDS,1,420,yomM
4760,gene,2245146,2246148,gene,1,1002,yomM
4761,CDS,2245146,2246148,CDS,1,1002,yozP
4763,CDS,2246150,2246480,CDS,-1,330,yomL
4762,gene,2246150,2246480,gene,-1,330,yozP
4764,gene,2246655,2247342,gene,-1,687,yomL
4765,CDS,2246655,2247342,CDS,-1,687,youB
4766,gene,2247366,2247543,gene,-1,177,youB
4767,CDS,2247366,2247543,CDS,-1,177,yomK
4768,gene,2247888,2248335,gene,1,447,yomK
4769,CDS,2247888,2248335,CDS,1,447,yomJ
4771,CDS,2248416,2249100,CDS,1,684,cwlP
4770,gene,2248416,2249100,gene,1,684,yomJ
4772,gene,2249153,2256011,gene,1,6858,cwlP
4773,CDS,2249153,2256011,CDS,1,6858,yomH
4774,gene,2256061,2256820,gene,1,759,yomH
4775,CDS,2256061,2256820,CDS,1,759,yomG
4776,gene,2256831,2259459,gene,1,2628,yomG
4777,CDS,2256831,2259459,CDS,1,2628,yomF
4778,gene,2259474,2260296,gene,1,822,yomF
4779,CDS,2259474,2260296,CDS,1,822,yomE
4781,CDS,2260332,2262267,CDS,1,1935,yomD
4780,gene,2260332,2262267,gene,1,1935,yomE
4782,gene,2262436,2263261,gene,1,825,yomD
4783,CDS,2262436,2263261,CDS,1,825,BSU_21409
4784,gene,2263250,2263469,gene,1,219,BSU_21409
4785,CDS,2263250,2263469,CDS,1,219,blyA
4786,gene,2263488,2264592,gene,1,1104,blyA
4787,CDS,2263488,2264592,CDS,1,1104,bhlA
4789,CDS,2264679,2264892,CDS,1,213,bhlB
4788,gene,2264679,2264892,gene,1,213,bhlA
4790,gene,2264902,2265169,gene,1,267,bhlB
4791,CDS,2264902,2265169,CDS,1,267,bdbB
4792,gene,2265224,2265671,gene,-1,447,bdbB
4793,CDS,2265224,2265671,CDS,-1,447,sunS
4794,gene,2265667,2266936,gene,-1,1269,sunS
4795,CDS,2265667,2266936,CDS,-1,1269,bdbA
4796,gene,2266935,2267349,gene,-1,414,bdbA
4797,CDS,2266935,2267349,CDS,-1,414,sunT
4799,CDS,2267345,2269463,CDS,-1,2118,sunA
4798,gene,2267345,2269463,gene,-1,2118,sunT
4800,gene,2269520,2269691,gene,-1,171,sunA
4801,CDS,2269520,2269691,CDS,-1,171,sunI
4802,gene,2269987,2270305,gene,-1,318,sunI
4803,CDS,2269987,2270305,CDS,-1,318,uvrX
4804,gene,2270406,2271657,gene,-1,1251,uvrX
4805,CDS,2270406,2271657,CDS,-1,1251,yolD
4806,gene,2271649,2271982,gene,-1,333,yolD
4807,CDS,2271649,2271982,CDS,-1,333,yolC
4808,gene,2272155,2272491,gene,1,336,yolC
4809,CDS,2272155,2272491,CDS,1,336,yolB
4810,gene,2272533,2272890,gene,-1,357,yolB
4811,CDS,2272533,2272890,CDS,-1,357,yolA
4812,gene,2272895,2273363,gene,-1,468,yolA
4813,CDS,2272895,2273363,CDS,-1,468,bsrG
4814,gene,2273593,2273710,gene,1,117,bsrG
4815,CDS,2273593,2273710,CDS,1,117,asrG
4816,gene,2273704,2273884,gene,-1,180,asrG
4817,misc_RNA,2273704,2273884,else,-1,180,yokL
4819,CDS,2273988,2274522,CDS,-1,534,yokK
4818,gene,2273988,2274522,gene,-1,534,yokL
4820,gene,2274557,2275136,gene,-1,579,yokK
4821,CDS,2274557,2275136,CDS,-1,579,yokJ
4822,gene,2275199,2275697,gene,-1,498,yokJ
4823,CDS,2275199,2275697,CDS,-1,498,yokI
4824,gene,2275705,2277421,gene,-1,1716,yokI
4825,CDS,2275705,2277421,CDS,-1,1716,yokH
4826,gene,2277520,2278078,gene,-1,558,yokH
4827,CDS,2277520,2278078,CDS,-1,558,yoyK
4828,gene,2278107,2278347,gene,1,240,yoyK
4829,misc_feature,2278107,2278347,else,1,240,yoyK
4830,gene,2278339,2278456,gene,1,117,yoyK
4831,misc_feature,2278339,2278456,else,1,117,yokG
4832,gene,2278601,2279675,gene,-1,1074,yokG
4833,CDS,2278601,2279675,CDS,-1,1074,nukF
4835,CDS,2279976,2280867,CDS,1,891,yokE
4834,gene,2279976,2280867,gene,1,891,nukF
4836,gene,2280880,2281363,gene,1,483,yokE
4837,CDS,2280880,2281363,CDS,1,483,aacD
4838,gene,2281666,2282485,gene,1,819,aacD
4839,CDS,2281666,2282485,CDS,1,819,BSU_21638
4840,gene,2282504,2282639,gene,-1,135,BSU_21638
4841,CDS,2282504,2282639,CDS,-1,135,BSU_21639
4843,CDS,2282800,2282956,CDS,-1,156,yokC
4842,gene,2282800,2282956,gene,-1,156,BSU_21639
4844,gene,2283135,2283651,gene,-1,516,yokC
4845,CDS,2283135,2283651,CDS,-1,516,yokB
4846,gene,2283857,2284568,gene,-1,711,yokB
4847,CDS,2283857,2284568,CDS,-1,711,sprA
4848,gene,2284770,2286408,gene,1,1638,sprA
4849,CDS,2284770,2286408,CDS,1,1638,spsMc
4850,gene,2286447,2287053,gene,1,606,spsMc
4851,misc_feature,2286447,2287053,else,1,606,msrB
4853,CDS,2287096,2287528,CDS,-1,432,msrA
4852,gene,2287096,2287528,gene,-1,432,msrB
4854,gene,2287528,2288062,gene,-1,534,msrA
4855,CDS,2287528,2288062,CDS,-1,534,ypoP
4856,gene,2288193,2288619,gene,1,426,ypoP
4857,CDS,2288193,2288619,CDS,1,426,dinF
4858,gene,2288668,2290006,gene,-1,1338,dinF
4859,CDS,2288668,2290006,CDS,-1,1338,ypmT
4861,CDS,2290077,2290272,CDS,-1,195,ypmS
4860,gene,2290077,2290272,gene,-1,195,ypmT
4862,gene,2290284,2290848,gene,-1,564,ypmS
4863,CDS,2290284,2290848,CDS,-1,564,ypmR
4864,gene,2290857,2291625,gene,-1,768,ypmR
4865,CDS,2290857,2291625,CDS,-1,768,scuA
4866,gene,2291702,2292284,gene,-1,582,scuA
4867,CDS,2291702,2292284,CDS,-1,582,ypmP
4868,gene,2292431,2292683,gene,-1,252,ypmP
4869,CDS,2292431,2292683,CDS,-1,252,ilvA
4871,CDS,2292768,2294037,CDS,-1,1269,silP
4870,gene,2292768,2294037,gene,-1,1269,ilvA
4872,gene,2294285,2295281,gene,1,996,silP
4873,CDS,2294285,2295281,CDS,1,996,yplQ
4874,gene,2295301,2295943,gene,1,642,yplQ
4875,CDS,2295301,2295943,CDS,1,642,ypkP
4876,gene,2295981,2296602,gene,-1,621,ypkP
4877,CDS,2295981,2296602,CDS,-1,621,dfrA
4878,gene,2296602,2297109,gene,-1,507,dfrA
4879,CDS,2296602,2297109,CDS,-1,507,thyB
4880,gene,2297105,2297900,gene,-1,795,thyB
4881,CDS,2297105,2297900,CDS,-1,795,ypjQ
4882,gene,2297983,2298517,gene,-1,534,ypjQ
4883,CDS,2297983,2298517,CDS,-1,534,ypjP
4884,gene,2298534,2299146,gene,-1,612,ypjP
4885,CDS,2298534,2299146,CDS,-1,612,rsmJ
4886,gene,2299405,2300179,gene,-1,774,rsmJ
4887,CDS,2299405,2300179,CDS,-1,774,brxA
4889,CDS,2300220,2300655,CDS,-1,435,ilvD
4888,gene,2300220,2300655,gene,-1,435,brxA
4890,gene,2300761,2302438,gene,-1,1677,ilvD
4891,CDS,2300761,2302438,CDS,-1,1677,ypgR
4892,gene,2302726,2303860,gene,-1,1134,ypgR
4893,CDS,2302726,2303860,CDS,-1,1134,hdhQ
4894,gene,2303919,2304537,gene,-1,618,hdhQ
4895,CDS,2303919,2304537,CDS,-1,618,bsaA
4897,CDS,2304552,2305035,CDS,-1,483,metAA
4896,gene,2304552,2305035,gene,-1,483,bsaA
4898,gene,2305377,2306283,gene,1,906,metAA
4899,CDS,2305377,2306283,CDS,1,906,ugtP
4900,gene,2306513,2307662,gene,1,1149,ugtP
4901,CDS,2306513,2307662,CDS,1,1149,BSU_21925
4902,gene,2307742,2307889,gene,1,147,BSU_21925
4903,CDS,2307742,2307889,CDS,1,147,cspD
4905,CDS,2307904,2308105,CDS,1,201,degR
4904,gene,2307904,2308105,gene,1,201,cspD
4907,CDS,2308156,2308339,CDS,-1,183,ypzA
4906,gene,2308156,2308339,gene,-1,183,degR
4908,gene,2308494,2308764,gene,1,270,ypzA
4909,CDS,2308494,2308764,CDS,1,270,ypeQ
4910,gene,2308791,2308974,gene,-1,183,ypeQ
4911,CDS,2308791,2308974,CDS,-1,183,ypeP
4912,gene,2308966,2309647,gene,-1,681,ypeP
4913,CDS,2308966,2309647,CDS,-1,681,queP
4914,gene,2309729,2310419,gene,1,690,queP
4915,CDS,2309729,2310419,CDS,1,690,ypdQ
4917,CDS,2310418,2310817,CDS,1,399,sspL
4916,gene,2310418,2310817,gene,1,399,ypdQ
4918,gene,2310858,2310987,gene,1,129,sspL
4919,CDS,2310858,2310987,CDS,1,129,exnP
4920,gene,2310994,2311885,gene,-1,891,exnP
4921,CDS,2310994,2311885,CDS,-1,891,ypzF
4922,gene,2311985,2312132,gene,-1,147,ypzF
4923,CDS,2311985,2312132,CDS,-1,147,ypbS
4925,CDS,2312206,2312464,CDS,-1,258,dynA
4924,gene,2312206,2312464,gene,-1,258,ypbS
4926,gene,2312528,2316110,gene,-1,3582,dynA
4927,CDS,2312528,2316110,CDS,-1,3582,fbpC
4928,gene,2316285,2316375,gene,-1,90,fbpC
4929,CDS,2316285,2316375,CDS,-1,90,bpsB
4930,gene,2316445,2316952,gene,-1,507,bpsB
4931,CDS,2316445,2316952,CDS,-1,507,bpsA
4932,gene,2316955,2318053,gene,-1,1098,bpsA
4933,CDS,2316955,2318053,CDS,-1,1098,pbuX
4934,gene,2318126,2319443,gene,-1,1317,pbuX
4935,CDS,2318126,2319443,CDS,-1,1317,xpt
4936,gene,2319439,2320024,gene,-1,585,xpt
4937,CDS,2319439,2320024,CDS,-1,585,gswA
4938,gene,2320112,2320213,gene,-1,101,gswA
4939,misc_RNA,2320112,2320213,else,-1,101,ypwA
4941,CDS,2320354,2321860,CDS,-1,1506,kdgT
4940,gene,2320354,2321860,gene,-1,1506,ypwA
4942,gene,2321971,2322964,gene,-1,993,kdgT
4943,CDS,2321971,2322964,CDS,-1,993,kdgA
4944,gene,2323008,2323599,gene,-1,591,kdgA
4945,CDS,2323008,2323599,CDS,-1,591,kdgK
4946,gene,2323600,2324575,gene,-1,975,kdgK
4947,CDS,2323600,2324575,CDS,-1,975,kdgR
4949,CDS,2324612,2325632,CDS,-1,1020,kduI
4948,gene,2324612,2325632,gene,-1,1020,kdgR
4950,gene,2325853,2326681,gene,1,828,kduI
4951,CDS,2325853,2326681,CDS,1,828,kduD
4952,gene,2326682,2327447,gene,1,765,kduD
4953,CDS,2326682,2327447,CDS,1,765,ypvA
4954,gene,2327487,2329413,gene,-1,1926,ypvA
4955,CDS,2327487,2329413,CDS,-1,1926,yptA
4956,gene,2329514,2329706,gene,-1,192,yptA
4957,CDS,2329514,2329706,CDS,-1,192,ypzG
4959,CDS,2329869,2330022,CDS,1,153,rlmKB
4958,gene,2329869,2330022,gene,1,153,ypzG
4961,CDS,2330074,2331232,CDS,-1,1158,rnpB
4960,gene,2330074,2331232,gene,-1,1158,rlmKB
4962,gene,2331319,2331720,gene,-1,401,rnpB
4963,misc_RNA,2331319,2331720,else,-1,401,gpsB
4964,gene,2331778,2332075,gene,-1,297,gpsB
4965,CDS,2331778,2332075,CDS,-1,297,ypsA
4966,gene,2332152,2332782,gene,-1,630,ypsA
4967,CDS,2332152,2332782,CDS,-1,630,cotD
4968,gene,2332783,2333011,gene,-1,228,cotD
4969,CDS,2332783,2333011,CDS,-1,228,BSU_22205
4970,gene,2333094,2333223,gene,-1,129,BSU_22205
4971,CDS,2333094,2333223,CDS,-1,129,yprB
4972,gene,2333323,2334565,gene,-1,1242,yprB
4973,CDS,2333323,2334565,CDS,-1,1242,yprA
4974,gene,2334580,2336830,gene,-1,2250,yprA
4975,CDS,2334580,2336830,CDS,-1,2250,ypqE
4976,gene,2336932,2337439,gene,-1,507,ypqE
4977,CDS,2336932,2337439,CDS,-1,507,ypqA
4979,CDS,2337576,2337996,CDS,1,420,yppG
4978,gene,2337576,2337996,gene,1,420,ypqA
4980,gene,2338016,2338394,gene,-1,378,yppG
4981,CDS,2338016,2338394,CDS,-1,378,yppF
4982,gene,2338581,2338770,gene,1,189,yppF
4983,CDS,2338581,2338770,CDS,1,189,yppE
4984,gene,2338808,2339180,gene,-1,372,yppE
4985,CDS,2338808,2339180,CDS,-1,372,yppD
4987,CDS,2339225,2339471,CDS,-1,246,sspM
4986,gene,2339225,2339471,gene,-1,246,yppD
4988,gene,2339669,2339774,gene,1,105,sspM
4989,CDS,2339669,2339774,CDS,1,105,yppC
4990,gene,2339798,2340761,gene,-1,963,yppC
4991,CDS,2339798,2340761,CDS,-1,963,recU
4992,gene,2340801,2341422,gene,1,621,recU
4993,CDS,2340801,2341422,CDS,1,621,ponA
4995,CDS,2341443,2344188,CDS,1,2745,ypoC
4994,gene,2341443,2344188,gene,1,2745,ponA
4997,CDS,2344263,2344758,CDS,-1,495,nth
4996,gene,2344263,2344758,gene,-1,495,ypoC
4998,gene,2344754,2345414,gene,-1,660,nth
4999,CDS,2344754,2345414,CDS,-1,660,dnaD
5000,gene,2345432,2346131,gene,-1,699,dnaD
5001,CDS,2345432,2346131,CDS,-1,699,asnS
5002,gene,2346223,2347516,gene,-1,1293,asnS
5003,CDS,2346223,2347516,CDS,-1,1293,aspB
5004,gene,2347659,2348841,gene,-1,1182,aspB
5005,CDS,2347659,2348841,CDS,-1,1182,tseB
5007,CDS,2348863,2349349,CDS,-1,486,ypmA
5006,gene,2348863,2349349,gene,-1,486,tseB
5008,gene,2349357,2349528,gene,-1,171,ypmA
5009,CDS,2349357,2349528,CDS,-1,171,dinG
5010,gene,2349670,2352466,gene,-1,2796,dinG
5011,CDS,2349670,2352466,CDS,-1,2796,panD
5012,gene,2352591,2352975,gene,-1,384,panD
5013,CDS,2352591,2352975,CDS,-1,384,panC
5015,CDS,2352976,2353837,CDS,-1,861,panB
5014,gene,2352976,2353837,gene,-1,861,panC
5016,gene,2353838,2354672,gene,-1,834,panB
5017,CDS,2353838,2354672,CDS,-1,834,birA
5018,gene,2354917,2355895,gene,-1,978,birA
5019,CDS,2354917,2355895,CDS,-1,978,cca
5020,gene,2355879,2357073,gene,-1,1194,cca
5021,CDS,2355879,2357073,CDS,-1,1194,bshA
5022,gene,2357077,2358211,gene,-1,1134,bshA
5023,CDS,2357077,2358211,CDS,-1,1134,bshBA
5024,gene,2358207,2358918,gene,-1,711,bshBA
5025,CDS,2358207,2358918,CDS,-1,711,mgsA
5026,gene,2358910,2359324,gene,-1,414,mgsA
5027,CDS,2358910,2359324,CDS,-1,414,dapB
5028,gene,2359339,2360143,gene,-1,804,dapB
5029,CDS,2359339,2360143,CDS,-1,804,ypjD
5031,CDS,2360154,2360490,CDS,-1,336,ypjC
5030,gene,2360154,2360490,gene,-1,336,ypjD
5032,gene,2360629,2361502,gene,1,873,ypjC
5033,CDS,2360629,2361502,CDS,1,873,ypjB
5034,gene,2361543,2362338,gene,-1,795,ypjB
5035,CDS,2361543,2362338,CDS,-1,795,ypjA
5036,gene,2362406,2362964,gene,-1,558,ypjA
5037,CDS,2362406,2362964,CDS,-1,558,qcrC
5038,gene,2363110,2363878,gene,-1,768,qcrC
5039,CDS,2363110,2363878,CDS,-1,768,qcrB
5040,gene,2363912,2364587,gene,-1,675,qcrB
5041,CDS,2363912,2364587,CDS,-1,675,qcrA
5042,gene,2364588,2365092,gene,-1,504,qcrA
5043,CDS,2364588,2365092,CDS,-1,504,ypiF
5044,gene,2365234,2365681,gene,-1,447,ypiF
5045,CDS,2365234,2365681,CDS,-1,447,ypiB
5047,CDS,2365735,2366275,CDS,-1,540,ypiA
5046,gene,2365735,2366275,gene,-1,540,ypiB
5048,gene,2366346,2367618,gene,-1,1272,ypiA
5049,CDS,2366346,2367618,CDS,-1,1272,aroA
5050,gene,2367953,2369240,gene,-1,1287,aroA
5051,CDS,2367953,2369240,CDS,-1,1287,tyrA
5052,gene,2369250,2370366,gene,-1,1116,tyrA
5053,CDS,2369250,2370366,CDS,-1,1116,hisC
5055,CDS,2370414,2371497,CDS,-1,1083,trpA
5054,gene,2370414,2371497,gene,-1,1083,hisC
5056,gene,2371507,2372311,gene,-1,804,trpA
5057,CDS,2371507,2372311,CDS,-1,804,trpB
5058,gene,2372303,2373506,gene,-1,1203,trpB
5059,CDS,2372303,2373506,CDS,-1,1203,trpF
5060,gene,2373486,2374134,gene,-1,648,trpF
5061,CDS,2373486,2374134,CDS,-1,648,trpC
5062,gene,2374138,2374888,gene,-1,750,trpC
5063,misc_feature,2374138,2374888,else,-1,750,trpD
5065,CDS,2374880,2375897,CDS,-1,1017,trpE
5064,gene,2374880,2375897,gene,-1,1017,trpD
5066,gene,2375868,2377416,gene,-1,1548,trpE
5067,CDS,2375868,2377416,CDS,-1,1548,aroH
5068,gene,2377631,2378015,gene,-1,384,aroH
5069,CDS,2377631,2378015,CDS,-1,384,aroB
5070,gene,2378011,2379100,gene,-1,1089,aroB
5071,CDS,2378011,2379100,CDS,-1,1089,aroF
5073,CDS,2379099,2380272,CDS,-1,1173,cheR
5072,gene,2379099,2380272,gene,-1,1173,aroF
5074,gene,2380346,2381117,gene,-1,771,cheR
5075,CDS,2380346,2381117,CDS,-1,771,ndk
5076,gene,2381353,2381803,gene,-1,450,ndk
5077,CDS,2381353,2381803,CDS,-1,450,hepT
5078,gene,2381918,2382965,gene,-1,1047,hepT
5079,CDS,2381918,2382965,CDS,-1,1047,menG
5080,gene,2382906,2383608,gene,-1,702,menG
5081,CDS,2382906,2383608,CDS,-1,702,hepS
5083,CDS,2383614,2384370,CDS,-1,756,mtrB
5082,gene,2383614,2384370,gene,-1,756,hepS
5084,gene,2384533,2384761,gene,-1,228,mtrB
5085,CDS,2384533,2384761,CDS,-1,228,folEA
5086,gene,2384782,2385355,gene,-1,573,folEA
5087,CDS,2384782,2385355,CDS,-1,573,hbs
5088,gene,2385542,2385821,gene,-1,279,hbs
5089,CDS,2385542,2385821,CDS,-1,279,spoIVA
5090,gene,2386194,2387673,gene,-1,1479,spoIVA
5091,CDS,2386194,2387673,CDS,-1,1479,yphF
5092,gene,2387853,2388588,gene,-1,735,yphF
5093,CDS,2387853,2388588,CDS,-1,735,yphE
5094,gene,2388609,2388813,gene,-1,204,yphE
5095,CDS,2388609,2388813,CDS,-1,204,gpsA
5096,gene,2389150,2390188,gene,-1,1038,gpsA
5097,CDS,2389150,2390188,CDS,-1,1038,der
5098,gene,2390205,2391516,gene,-1,1311,der
5099,CDS,2390205,2391516,CDS,-1,1311,ypzH
5100,gene,2391669,2391864,gene,-1,195,ypzH
5101,CDS,2391669,2391864,CDS,-1,195,yphB
5103,CDS,2391860,2392754,CDS,-1,894,yphA
5102,gene,2391860,2392754,gene,-1,894,yphB
5104,gene,2392750,2393350,gene,-1,600,yphA
5105,CDS,2392750,2393350,CDS,-1,600,ypzI
5106,gene,2393427,2393559,gene,1,132,ypzI
5107,CDS,2393427,2393559,CDS,1,132,fni
5108,gene,2393601,2394651,gene,-1,1050,fni
5109,CDS,2393601,2394651,CDS,-1,1050,rpfA
5110,gene,2394663,2395812,gene,-1,1149,rpfA
5111,CDS,2394663,2395812,CDS,-1,1149,cmk
5112,gene,2396044,2396719,gene,-1,675,cmk
5113,CDS,2396044,2396719,CDS,-1,675,ypfB
5114,gene,2396797,2396974,gene,-1,177,ypfB
5115,CDS,2396797,2396974,CDS,-1,177,dgrA
5116,gene,2397018,2397672,gene,-1,654,dgrA
5117,CDS,2397018,2397672,CDS,-1,654,sleC
5119,CDS,2397764,2399117,CDS,-1,1353,sleB
5118,gene,2397764,2399117,gene,-1,1353,sleC
5120,gene,2399151,2400069,gene,-1,918,sleB
5121,CDS,2399151,2400069,CDS,-1,918,prsW
5122,gene,2400207,2400864,gene,-1,657,prsW
5123,CDS,2400207,2400864,CDS,-1,657,ypdA
5124,gene,2400983,2401958,gene,-1,975,ypdA
5125,CDS,2400983,2401958,CDS,-1,975,gudB
5127,CDS,2402066,2403350,CDS,-1,1284,mecB
5126,gene,2402066,2403350,gene,-1,1284,gudB
5128,gene,2403505,2404090,gene,-1,585,mecB
5129,CDS,2403505,2404090,CDS,-1,585,ypbG
5130,gene,2404248,2405028,gene,-1,780,ypbG
5131,CDS,2404248,2405028,CDS,-1,780,ypbF
5132,gene,2405113,2405557,gene,-1,444,ypbF
5133,CDS,2405113,2405557,CDS,-1,444,ypbE
5134,gene,2405619,2406342,gene,-1,723,ypbE
5135,CDS,2405619,2406342,CDS,-1,723,ypbD
5137,CDS,2406292,2406862,CDS,-1,570,recS
5136,gene,2406292,2406862,gene,-1,570,ypbD
5138,gene,2406921,2408412,gene,-1,1491,recS
5139,CDS,2406921,2408412,CDS,-1,1491,gmmB
5140,gene,2408404,2409463,gene,-1,1059,gmmB
5141,CDS,2408404,2409463,CDS,-1,1059,fer
5142,gene,2409728,2409977,gene,1,249,fer
5143,CDS,2409728,2409977,CDS,1,249,fmnP
5145,CDS,2410016,2410589,CDS,-1,573,fswB
5144,gene,2410016,2410589,gene,-1,573,fmnP
5146,gene,2410580,2410888,gene,-1,308,fswB
5147,misc_RNA,2410580,2410888,else,-1,308,serA
5148,gene,2411085,2412663,gene,1,1578,serA
5149,CDS,2411085,2412663,CDS,1,1578,aroC
5150,gene,2412705,2413473,gene,-1,768,aroC
5151,CDS,2412705,2413473,CDS,-1,768,rsiX
5152,gene,2413584,2414691,gene,-1,1107,rsiX
5153,CDS,2413584,2414691,CDS,-1,1107,sigX
5155,CDS,2414626,2415211,CDS,-1,585,resE
5154,gene,2414626,2415211,gene,-1,585,sigX
5156,gene,2415414,2417184,gene,-1,1770,resE
5157,CDS,2415414,2417184,CDS,-1,1770,resD
5158,gene,2417180,2417903,gene,-1,723,resD
5159,CDS,2417180,2417903,CDS,-1,723,resC
5160,gene,2417983,2419159,gene,-1,1176,resC
5161,CDS,2417983,2419159,CDS,-1,1176,resB
5162,gene,2419178,2420807,gene,-1,1629,resB
5163,CDS,2419178,2420807,CDS,-1,1629,resA
5164,gene,2420803,2421343,gene,-1,540,resA
5165,CDS,2420803,2421343,CDS,-1,540,rluB
5166,gene,2421437,2422172,gene,-1,735,rluB
5167,CDS,2421437,2422172,CDS,-1,735,spmB
5168,gene,2422263,2422800,gene,-1,537,spmB
5169,CDS,2422263,2422800,CDS,-1,537,spmA
5170,gene,2422804,2423395,gene,-1,591,spmA
5171,CDS,2422804,2423395,CDS,-1,591,dacB
5173,CDS,2423382,2424531,CDS,-1,1149,ypuI
5172,gene,2423382,2424531,gene,-1,1149,dacB
5174,gene,2424653,2425193,gene,-1,540,ypuI
5175,CDS,2424653,2425193,CDS,-1,540,spcB
5176,gene,2425247,2425841,gene,-1,594,spcB
5177,CDS,2425247,2425841,CDS,-1,594,scpA
5178,gene,2425830,2426586,gene,-1,756,scpA
5179,CDS,2425830,2426586,CDS,-1,756,ypuF
5181,CDS,2426866,2427391,CDS,1,525,ypzK
5180,gene,2426866,2427391,gene,1,525,ypuF
5182,gene,2427404,2427779,gene,-1,375,ypzK
5183,CDS,2427404,2427779,CDS,-1,375,ribH
5184,gene,2427891,2428356,gene,-1,465,ribH
5185,CDS,2427891,2428356,CDS,-1,465,ribBA
5186,gene,2428388,2429585,gene,-1,1197,ribBA
5187,CDS,2428388,2429585,CDS,-1,1197,ribE
5189,CDS,2429599,2430247,CDS,-1,648,ribD
5188,gene,2429599,2430247,gene,-1,648,ribE
5191,CDS,2430257,2431343,CDS,-1,1086,fswA
5190,gene,2430257,2431343,gene,-1,1086,ribD
5192,gene,2431472,2431617,gene,-1,145,fswA
5193,misc_RNA,2431472,2431617,else,-1,145,ypuD
5194,gene,2431736,2432081,gene,-1,345,ypuD
5195,CDS,2431736,2432081,CDS,-1,345,sipS
5196,gene,2432315,2432870,gene,-1,555,sipS
5197,CDS,2432315,2432870,CDS,-1,555,ypzC
5198,gene,2433136,2433373,gene,1,237,ypzC
5199,CDS,2433136,2433373,CDS,1,237,ypzJ
5201,CDS,2433315,2433522,CDS,-1,207,ypuC
5200,gene,2433315,2433522,gene,-1,207,ypzJ
5202,gene,2433630,2433885,gene,-1,255,ypuC
5203,misc_feature,2433630,2433885,else,-1,255,ypuC
5204,gene,2433877,2434165,gene,-1,288,ypuC
5205,misc_feature,2433877,2434165,else,-1,288,ypuB
5206,gene,2434142,2434346,gene,-1,204,ypuB
5207,CDS,2434142,2434346,CDS,-1,204,BSU_23349
5209,misc_feature,2434754,2434871,else,1,117,ypzD
5208,gene,2434754,2434871,gene,1,117,BSU_23349
5210,gene,2435011,2435224,gene,1,213,ypzD
5211,CDS,2435011,2435224,CDS,1,213,ppiB
5212,gene,2435359,2435791,gene,-1,432,ppiB
5213,CDS,2435359,2435791,CDS,-1,432,ypuA
5214,gene,2436044,2436917,gene,1,873,ypuA
5215,CDS,2436044,2436917,CDS,1,873,lysA
5216,gene,2436946,2438266,gene,-1,1320,lysA
5217,CDS,2436946,2438266,CDS,-1,1320,spoVAF
5218,gene,2438371,2439853,gene,-1,1482,spoVAF
5219,CDS,2438371,2439853,CDS,-1,1482,spoVAEA
5220,gene,2439803,2440415,gene,-1,612,spoVAEA
5221,CDS,2439803,2440415,CDS,-1,612,spoVAEB
5222,gene,2440422,2440773,gene,-1,351,spoVAEB
5223,CDS,2440422,2440773,CDS,-1,351,spoVAD
5225,CDS,2440774,2441791,CDS,-1,1017,spoVAC
5224,gene,2440774,2441791,gene,-1,1017,spoVAD
5226,gene,2441803,2442256,gene,-1,453,spoVAC
5227,CDS,2441803,2442256,CDS,-1,453,spoVAB
5228,gene,2442268,2442694,gene,-1,426,spoVAB
5229,CDS,2442268,2442694,CDS,-1,426,spoVAA
5230,gene,2442683,2443304,gene,-1,621,spoVAA
5231,CDS,2442683,2443304,CDS,-1,621,sigF
5233,CDS,2443428,2444196,CDS,-1,768,spoIIAB
5232,gene,2443428,2444196,gene,-1,768,sigF
5234,gene,2444207,2444648,gene,-1,441,spoIIAB
5235,CDS,2444207,2444648,CDS,-1,441,spoIIAA
5236,gene,2444644,2444998,gene,-1,354,spoIIAA
5237,CDS,2444644,2444998,CDS,-1,354,dacF
5238,gene,2445093,2446263,gene,-1,1170,dacF
5239,CDS,2445093,2446263,CDS,-1,1170,pupG
5240,gene,2446417,2447233,gene,-1,816,pupG
5241,CDS,2446417,2447233,CDS,-1,816,deoB
5243,CDS,2447245,2448430,CDS,-1,1185,ripX
5242,gene,2447245,2448430,gene,-1,1185,deoB
5245,CDS,2448590,2449481,CDS,-1,891,yqzK
5244,gene,2448590,2449481,gene,-1,891,ripX
5246,gene,2449488,2449716,gene,-1,228,yqzK
5247,CDS,2449488,2449716,CDS,-1,228,fur
5248,gene,2449840,2450290,gene,-1,450,fur
5249,CDS,2449840,2450290,CDS,-1,450,spoIIM
5250,gene,2450402,2451047,gene,-1,645,spoIIM
5251,CDS,2450402,2451047,CDS,-1,645,yqkK
5252,gene,2451147,2451363,gene,-1,216,yqkK
5253,CDS,2451147,2451363,CDS,-1,216,mleA
5255,CDS,2451462,2452782,CDS,-1,1320,mleN
5254,gene,2451462,2452782,gene,-1,1320,mleA
5256,gene,2452799,2454206,gene,-1,1407,mleN
5257,CDS,2452799,2454206,CDS,-1,1407,ansB
5258,gene,2454346,2455774,gene,-1,1428,ansB
5259,CDS,2454346,2455774,CDS,-1,1428,ansA
5260,gene,2455818,2456808,gene,-1,990,ansA
5261,CDS,2455818,2456808,CDS,-1,990,ansR
5263,CDS,2456989,2457340,CDS,1,351,yqxK
5262,gene,2456989,2457340,gene,1,351,ansR
5264,gene,2457348,2458512,gene,-1,1164,yqxK
5265,CDS,2457348,2458512,CDS,-1,1164,nudF
5266,gene,2458508,2459066,gene,-1,558,nudF
5267,CDS,2458508,2459066,CDS,-1,558,mciZ
5268,gene,2459140,2459263,gene,1,123,mciZ
5269,CDS,2459140,2459263,CDS,1,123,yqkF
5270,gene,2459325,2460246,gene,1,921,yqkF
5271,CDS,2459325,2460246,CDS,1,921,yqkE
5272,gene,2460277,2460502,gene,-1,225,yqkE
5273,CDS,2460277,2460502,CDS,-1,225,yqkD
5274,gene,2460663,2461581,gene,1,918,yqkD
5275,CDS,2460663,2461581,CDS,1,918,yqkC
5276,gene,2461620,2461860,gene,-1,240,yqkC
5277,CDS,2461620,2461860,CDS,-1,240,yqkB
5278,gene,2461872,2462196,gene,-1,324,yqkB
5279,CDS,2461872,2462196,CDS,-1,324,yqkA
5281,CDS,2462192,2463224,CDS,-1,1032,yqjZ
5280,gene,2462192,2463224,gene,-1,1032,yqkA
5282,gene,2463216,2463561,gene,-1,345,yqjZ
5283,CDS,2463216,2463561,CDS,-1,345,yqjY
5284,gene,2463570,2464041,gene,-1,471,yqjY
5285,CDS,2463570,2464041,CDS,-1,471,yqjX
5286,gene,2464226,2464565,gene,-1,339,yqjX
5287,CDS,2464226,2464565,CDS,-1,339,polYB
5289,CDS,2464561,2465800,CDS,-1,1239,yqzH
5288,gene,2464561,2465800,gene,-1,1239,polYB
5290,gene,2465965,2466172,gene,1,207,yqzH
5291,CDS,2465965,2466172,CDS,1,207,yqjV
5292,gene,2466720,2467953,gene,1,1233,yqjV
5293,CDS,2466720,2467953,CDS,1,1233,yqjU
5294,gene,2467799,2468162,gene,1,363,yqjU
5295,CDS,2467799,2468162,CDS,1,363,yqjT
5296,gene,2468158,2468545,gene,-1,387,yqjT
5297,CDS,2468158,2468545,CDS,-1,387,coaA
5299,CDS,2468548,2469508,CDS,-1,960,dsdA
5298,gene,2468548,2469508,gene,-1,960,coaA
5300,gene,2469579,2470926,gene,-1,1347,dsdA
5301,CDS,2469579,2470926,CDS,-1,1347,yqjQ
5302,gene,2471001,2471781,gene,-1,780,yqjQ
5303,CDS,2471001,2471781,CDS,-1,780,yqjP
5304,gene,2471786,2472746,gene,-1,960,yqjP
5305,CDS,2471786,2472746,CDS,-1,960,pswI
5306,gene,2472879,2473125,gene,1,246,pswI
5307,misc_RNA,2472879,2473125,else,1,246,proI
5308,gene,2473150,2473987,gene,1,837,proI
5309,CDS,2473150,2473987,CDS,1,837,yqjN
5310,gene,2474027,2475671,gene,-1,1644,yqjN
5311,CDS,2474027,2475671,CDS,-1,1644,yqjM
5312,gene,2475842,2476859,gene,1,1017,yqjM
5313,CDS,2475842,2476859,CDS,1,1017,yqjL
5315,CDS,2476968,2477730,CDS,1,762,rpmGCc
5314,gene,2476968,2477730,gene,1,762,yqjL
5317,misc_feature,2477776,2477899,else,-1,123,rpmGCn
5316,gene,2477776,2477899,gene,-1,123,rpmGCc
5318,gene,2477891,2477924,gene,-1,33,rpmGCn
5319,misc_feature,2477891,2477924,else,-1,33,rnz
5320,gene,2478005,2478929,gene,-1,924,rnz
5321,CDS,2478005,2478929,CDS,-1,924,zwf
5322,gene,2479155,2480625,gene,1,1470,zwf
5323,CDS,2479155,2480625,CDS,1,1470,gndA
5324,gene,2480749,2482159,gene,-1,1410,gndA
5325,CDS,2480749,2482159,CDS,-1,1410,polYA
5326,gene,2482268,2483513,gene,-1,1245,polYA
5327,CDS,2482268,2483513,CDS,-1,1245,mifM
5328,gene,2483585,2483873,gene,1,288,mifM
5329,CDS,2483585,2483873,CDS,1,288,oxaAB
5330,gene,2483903,2484731,gene,1,828,oxaAB
5331,CDS,2483903,2484731,CDS,1,828,yqjF
5332,gene,2484910,2485639,gene,1,729,yqjF
5333,CDS,2484910,2485639,CDS,1,729,yqjE
5335,CDS,2485679,2486795,CDS,-1,1116,yqjD
5334,gene,2485679,2486795,gene,-1,1116,yqjE
5336,gene,2486812,2488336,gene,-1,1524,yqjD
5337,CDS,2486812,2488336,CDS,-1,1524,yqjC
5338,gene,2488328,2488751,gene,-1,423,yqjC
5339,CDS,2488328,2488751,CDS,-1,423,yqjB
5340,gene,2488952,2489483,gene,-1,531,yqjB
5341,CDS,2488952,2489483,CDS,-1,531,yqjA
5343,CDS,2489534,2490503,CDS,-1,969,artR
5342,gene,2489534,2490503,gene,-1,969,yqjA
5344,gene,2490573,2491296,gene,-1,723,artR
5345,CDS,2490573,2491296,CDS,-1,723,artQ
5346,gene,2491288,2491948,gene,-1,660,artQ
5347,CDS,2491288,2491948,CDS,-1,660,artP
5348,gene,2492028,2492796,gene,-1,768,artP
5349,CDS,2492028,2492796,CDS,-1,768,brxB
5351,CDS,2493063,2493501,CDS,-1,438,bmrU
5350,gene,2493063,2493501,gene,-1,438,brxB
5353,CDS,2493661,2494555,CDS,1,894,bmr
5352,gene,2493661,2494555,gene,1,894,bmrU
5354,gene,2494655,2495825,gene,1,1170,bmr
5355,CDS,2494655,2495825,CDS,1,1170,bmrR
5356,gene,2495897,2496734,gene,1,837,bmrR
5357,CDS,2495897,2496734,CDS,1,837,bkdB
5358,gene,2496795,2498070,gene,-1,1275,bkdB
5359,CDS,2496795,2498070,CDS,-1,1275,bkdAB
5360,gene,2498092,2499076,gene,-1,984,bkdAB
5361,CDS,2498092,2499076,CDS,-1,984,bkdAA
5363,CDS,2499089,2500082,CDS,-1,993,lpdV
5362,gene,2499089,2500082,gene,-1,993,bkdAA
5364,gene,2500103,2501528,gene,-1,1425,lpdV
5365,CDS,2500103,2501528,CDS,-1,1425,buk
5366,gene,2501548,2502640,gene,-1,1092,buk
5367,CDS,2501548,2502640,CDS,-1,1092,bcd
5368,gene,2502658,2503753,gene,-1,1095,bcd
5369,CDS,2502658,2503753,CDS,-1,1095,ptb
5371,CDS,2503764,2504664,CDS,-1,900,bkdR
5370,gene,2503764,2504664,gene,-1,900,ptb
5372,gene,2504788,2506867,gene,-1,2079,bkdR
5373,CDS,2504788,2506867,CDS,-1,2079,yqzF
5374,gene,2507019,2507256,gene,1,237,yqzF
5375,CDS,2507019,2507256,CDS,1,237,mmgF
5376,gene,2507297,2508203,gene,-1,906,mmgF
5377,CDS,2507297,2508203,CDS,-1,906,mmgE
5378,gene,2508220,2509639,gene,-1,1419,mmgE
5379,CDS,2508220,2509639,CDS,-1,1419,mmgD
5380,gene,2509653,2510772,gene,-1,1119,mmgD
5381,CDS,2509653,2510772,CDS,-1,1119,mmgC
5382,gene,2510805,2511945,gene,-1,1140,mmgC
5383,CDS,2510805,2511945,CDS,-1,1140,mmgB
5384,gene,2511972,2512836,gene,-1,864,mmgB
5385,CDS,2511972,2512836,CDS,-1,864,mmgA
5387,CDS,2512860,2514042,CDS,-1,1182,glpQ
5386,gene,2512860,2514042,gene,-1,1182,mmgA
5388,gene,2514168,2514900,gene,-1,732,glpQ
5389,CDS,2514168,2514900,CDS,-1,732,yqiI
5390,gene,2514978,2515599,gene,-1,621,yqiI
5391,CDS,2514978,2515599,CDS,-1,621,yqiH
5392,gene,2515613,2515907,gene,-1,294,yqiH
5393,CDS,2515613,2515907,CDS,-1,294,BSU_24205
5394,gene,2516214,2516367,gene,1,153,BSU_24205
5395,CDS,2516214,2516367,CDS,1,153,yqiG
5396,gene,2516439,2517558,gene,1,1119,yqiG
5397,CDS,2516439,2517558,CDS,1,1119,spo0A
5398,gene,2518022,2518826,gene,-1,804,spo0A
5399,CDS,2518022,2518826,CDS,-1,804,spoIVB
5400,gene,2519101,2520382,gene,-1,1281,spoIVB
5401,CDS,2519101,2520382,CDS,-1,1281,recN
5402,gene,2520556,2522287,gene,-1,1731,recN
5403,CDS,2520556,2522287,CDS,-1,1731,argR
5405,CDS,2522323,2522773,CDS,-1,450,yqxC
5404,gene,2522323,2522773,gene,-1,450,argR
5406,gene,2522870,2523716,gene,-1,846,yqxC
5407,CDS,2522870,2523716,CDS,-1,846,dxs
5408,gene,2523712,2525614,gene,-1,1902,dxs
5409,CDS,2523712,2525614,CDS,-1,1902,ispA
5410,gene,2525788,2526679,gene,-1,891,ispA
5411,CDS,2525788,2526679,CDS,-1,891,xseB
5413,CDS,2526668,2526923,CDS,-1,255,xseA
5412,gene,2526668,2526923,gene,-1,255,xseB
5414,gene,2526919,2528266,gene,-1,1347,xseA
5415,CDS,2526919,2528266,CDS,-1,1347,folD
5416,gene,2528403,2529255,gene,-1,852,folD
5417,CDS,2528403,2529255,CDS,-1,852,nusB
5418,gene,2529266,2529662,gene,-1,396,nusB
5419,CDS,2529266,2529662,CDS,-1,396,yqhY
5421,CDS,2529925,2530333,CDS,-1,408,accC
5420,gene,2529925,2530333,gene,-1,408,yqhY
5423,CDS,2530353,2531706,CDS,-1,1353,accB
5422,gene,2530353,2531706,gene,-1,1353,accC
5424,gene,2531717,2532197,gene,-1,480,accB
5425,CDS,2531717,2532197,CDS,-1,480,spoIIIAH
5426,gene,2532352,2533009,gene,-1,657,spoIIIAH
5427,CDS,2532352,2533009,CDS,-1,657,spoIIIAG
5428,gene,2533009,2533699,gene,-1,690,spoIIIAG
5429,CDS,2533009,2533699,CDS,-1,690,spoIIIAF
5430,gene,2533691,2534312,gene,-1,621,spoIIIAF
5431,CDS,2533691,2534312,CDS,-1,621,spoIIIAE
5433,CDS,2534325,2535525,CDS,-1,1200,spoIIIAD
5432,gene,2534325,2535525,gene,-1,1200,spoIIIAE
5434,gene,2535543,2535945,gene,-1,402,spoIIIAD
5435,CDS,2535543,2535945,CDS,-1,402,spoIIIAC
5436,gene,2535951,2536158,gene,-1,207,spoIIIAC
5437,CDS,2535951,2536158,CDS,-1,207,spoIIIAB
5438,gene,2536180,2536696,gene,-1,516,spoIIIAB
5439,CDS,2536180,2536696,CDS,-1,516,spoIIIAA
5441,CDS,2536689,2537613,CDS,-1,924,yqhV
5440,gene,2536689,2537613,gene,-1,924,spoIIIAA
5442,gene,2537688,2537970,gene,-1,282,yqhV
5443,CDS,2537688,2537970,CDS,-1,282,efp
5444,gene,2538114,2538672,gene,-1,558,efp
5445,CDS,2538114,2538672,CDS,-1,558,papA
5446,gene,2538696,2539758,gene,-1,1062,papA
5447,CDS,2538696,2539758,CDS,-1,1062,yqhS
5448,gene,2539754,2540201,gene,-1,447,yqhS
5449,CDS,2539754,2540201,CDS,-1,447,yqhR
5450,gene,2540287,2540824,gene,-1,537,yqhR
5451,CDS,2540287,2540824,CDS,-1,537,yqhQ
5452,gene,2541050,2542007,gene,1,957,yqhQ
5453,CDS,2541050,2542007,CDS,1,957,yqhP
5454,gene,2542046,2542442,gene,1,396,yqhP
5455,CDS,2542046,2542442,CDS,1,396,yqhO
5457,CDS,2542438,2543314,CDS,-1,876,mntR
5456,gene,2542438,2543314,gene,-1,876,yqhO
5458,gene,2543439,2543868,gene,-1,429,mntR
5459,CDS,2543439,2543868,CDS,-1,429,lipM
5460,gene,2543967,2544804,gene,-1,837,lipM
5461,CDS,2543967,2544804,CDS,-1,837,yqhL
5462,gene,2544994,2545375,gene,1,381,yqhL
5463,CDS,2544994,2545375,CDS,1,381,gcvPB
5464,gene,2545409,2546876,gene,-1,1467,gcvPB
5465,CDS,2545409,2546876,CDS,-1,1467,gcvPA
5466,gene,2546868,2548215,gene,-1,1347,gcvPA
5467,CDS,2546868,2548215,CDS,-1,1347,gcvT
5468,gene,2548244,2549333,gene,-1,1089,gcvT
5469,CDS,2548244,2549333,CDS,-1,1089,swgA
5470,gene,2549406,2549606,gene,-1,200,swgA
5471,misc_RNA,2549406,2549606,else,-1,200,yqhH
5473,CDS,2549774,2551448,CDS,1,1674,yqhG
5472,gene,2549774,2551448,gene,1,1674,yqhH
5474,gene,2551468,2552263,gene,1,795,yqhG
5475,CDS,2551468,2552263,CDS,1,795,sinI
5476,gene,2552445,2552619,gene,1,174,sinI
5477,CDS,2552445,2552619,CDS,1,174,sinR
5478,gene,2552652,2552988,gene,1,336,sinR
5479,CDS,2552652,2552988,CDS,1,336,tasA
5481,CDS,2553080,2553866,CDS,-1,786,sipW
5480,gene,2553080,2553866,gene,-1,786,tasA
5482,gene,2553929,2554502,gene,-1,573,sipW
5483,CDS,2553929,2554502,CDS,-1,573,tapA
5484,gene,2554485,2555247,gene,-1,762,tapA
5485,CDS,2554485,2555247,CDS,-1,762,yqzG
5486,gene,2555518,2555845,gene,1,327,yqzG
5487,CDS,2555518,2555845,CDS,1,327,spoIIT
5488,gene,2555886,2556066,gene,-1,180,spoIIT
5489,CDS,2555886,2556066,CDS,-1,180,comGG
5491,CDS,2556136,2556511,CDS,-1,375,comGF
5490,gene,2556136,2556511,gene,-1,375,comGG
5492,gene,2556511,2556895,gene,-1,384,comGF
5493,CDS,2556511,2556895,CDS,-1,384,comGE
5494,gene,2556920,2557268,gene,-1,348,comGE
5495,CDS,2556920,2557268,CDS,-1,348,comGD
5496,gene,2557251,2557683,gene,-1,432,comGD
5497,CDS,2557251,2557683,CDS,-1,432,comGC
5499,CDS,2557672,2557969,CDS,-1,297,comGB
5498,gene,2557672,2557969,gene,-1,297,comGC
5500,gene,2557982,2558954,gene,-1,972,comGB
5501,CDS,2557982,2558954,CDS,-1,972,comGA
5502,gene,2559006,2560077,gene,-1,1071,comGA
5503,CDS,2559006,2560077,CDS,-1,1071,yqxL
5504,gene,2560488,2561442,gene,-1,954,yqxL
5505,CDS,2560488,2561442,CDS,-1,954,yqhB
5506,gene,2561584,2562913,gene,1,1329,yqhB
5507,CDS,2561584,2562913,CDS,1,1329,rsbRD
5509,CDS,2562965,2563802,CDS,-1,837,trnSL-Gln1
5508,gene,2562965,2563802,gene,-1,837,rsbRD
5510,gene,2563888,2563959,gene,1,71,trnSL-Gln1
5511,tRNA,2563888,2563959,else,1,71,mgsR
5512,gene,2564025,2564406,gene,-1,381,mgsR
5513,CDS,2564025,2564406,CDS,-1,381,yqgY
5514,gene,2564637,2564883,gene,1,246,yqgY
5515,CDS,2564637,2564883,CDS,1,246,yqgX
5516,gene,2564922,2565558,gene,-1,636,yqgX
5517,CDS,2564922,2565558,CDS,-1,636,yqgW
5518,gene,2565714,2565888,gene,1,174,yqgW
5519,CDS,2565714,2565888,CDS,1,174,yqgV
5520,gene,2565919,2566234,gene,-1,315,yqgV
5521,CDS,2565919,2566234,CDS,-1,315,yqgU
5522,gene,2566236,2567298,gene,-1,1062,yqgU
5523,CDS,2566236,2567298,CDS,-1,1062,yqgT
5524,gene,2567359,2568490,gene,-1,1131,yqgT
5525,CDS,2567359,2568490,CDS,-1,1131,ltaSC
5527,CDS,2568572,2570489,CDS,-1,1917,glcK
5526,gene,2568572,2570489,gene,-1,1917,ltaSC
5528,gene,2570605,2571571,gene,-1,966,glcK
5529,CDS,2570605,2571571,CDS,-1,966,yqgQ
5530,gene,2571581,2571797,gene,-1,216,yqgQ
5531,CDS,2571581,2571797,CDS,-1,216,glpG
5532,gene,2571906,2573430,gene,-1,1524,glpG
5533,CDS,2571906,2573430,CDS,-1,1524,yqgO
5534,gene,2573519,2573693,gene,-1,174,yqgO
5535,CDS,2573519,2573693,CDS,-1,174,folN
5536,gene,2573759,2574323,gene,-1,564,folN
5537,CDS,2573759,2574323,CDS,-1,564,rpmGA
5538,gene,2574407,2574557,gene,-1,150,rpmGA
5539,CDS,2574407,2574557,CDS,-1,150,yqgM
5540,gene,2574640,2575720,gene,-1,1080,yqgM
5541,CDS,2574640,2575720,CDS,-1,1080,yqgL
5543,CDS,2575716,2576187,CDS,-1,471,yqzD
5542,gene,2575716,2576187,gene,-1,471,yqgL
5544,gene,2576366,2576720,gene,1,354,yqzD
5545,CDS,2576366,2576720,CDS,1,354,yqzC
5546,gene,2576716,2577181,gene,1,465,yqzC
5547,CDS,2576716,2577181,CDS,1,465,pstBB
5548,gene,2577209,2577992,gene,-1,783,pstBB
5549,CDS,2577209,2577992,CDS,-1,783,pstBA
5551,CDS,2578002,2578812,CDS,-1,810,pstA
5550,gene,2578002,2578812,gene,-1,810,pstBA
5552,gene,2578832,2579717,gene,-1,885,pstA
5553,CDS,2578832,2579717,CDS,-1,885,pstC
5554,gene,2579716,2580646,gene,-1,930,pstC
5555,CDS,2579716,2580646,CDS,-1,930,pstS
5556,gene,2580714,2581617,gene,-1,903,pstS
5557,CDS,2580714,2581617,CDS,-1,903,pbpA
5558,gene,2581770,2583921,gene,-1,2151,pbpA
5559,CDS,2581770,2583921,CDS,-1,2151,yqgE
5561,CDS,2584034,2585327,CDS,-1,1293,sodA
5560,gene,2584034,2585327,gene,-1,1293,yqgE
5562,gene,2585433,2586042,gene,-1,609,sodA
5563,CDS,2585433,2586042,CDS,-1,609,yqgC
5564,gene,2586220,2586703,gene,-1,483,yqgC
5565,CDS,2586220,2586703,CDS,-1,483,yqgB
5566,gene,2586812,2587580,gene,1,768,yqgB
5567,CDS,2586812,2587580,CDS,1,768,yqgA
5569,CDS,2587995,2588424,CDS,-1,429,yqfZ
5568,gene,2587995,2588424,gene,-1,429,yqgA
5570,gene,2588700,2589000,gene,1,300,yqfZ
5571,CDS,2588700,2589000,CDS,1,300,ispG
5572,gene,2589122,2590256,gene,1,1134,ispG
5573,CDS,2589122,2590256,CDS,1,1134,yqfX
5574,gene,2590281,2590671,gene,-1,390,yqfX
5575,CDS,2590281,2590671,CDS,-1,390,yqfW
5576,gene,2590803,2591385,gene,1,582,yqfW
5577,CDS,2590803,2591385,CDS,1,582,zur
5579,CDS,2591427,2591865,CDS,-1,438,yqfU
5578,gene,2591427,2591865,gene,-1,438,zur
5580,gene,2592002,2592884,gene,-1,882,yqfU
5581,CDS,2592002,2592884,CDS,-1,882,yqfT
5582,gene,2592999,2593254,gene,1,255,yqfT
5583,CDS,2592999,2593254,CDS,1,255,nfo
5584,gene,2593280,2594174,gene,-1,894,nfo
5585,CDS,2593280,2594174,CDS,-1,894,cshB
5586,gene,2594183,2595500,gene,-1,1317,cshB
5587,CDS,2594183,2595500,CDS,-1,1317,yqfQ
5588,gene,2595668,2596412,gene,1,744,yqfQ
5589,CDS,2595668,2596412,CDS,1,744,ispH
5590,gene,2596534,2597479,gene,1,945,ispH
5591,CDS,2596534,2597479,CDS,1,945,yqfO
5592,gene,2597501,2598623,gene,-1,1122,yqfO
5593,CDS,2597501,2598623,CDS,-1,1122,trmK
5595,CDS,2598615,2599266,CDS,-1,651,cccA
5594,gene,2598615,2599266,gene,-1,651,trmK
5597,CDS,2599522,2599885,CDS,-1,363,sigA
5596,gene,2599522,2599885,gene,-1,363,cccA
5598,gene,2600213,2601329,gene,-1,1116,sigA
5599,CDS,2600213,2601329,CDS,-1,1116,dnaG
5600,gene,2601527,2603339,gene,-1,1812,dnaG
5601,CDS,2601527,2603339,CDS,-1,1812,antE
5602,gene,2602978,2603275,gene,1,297,antE
5603,CDS,2602978,2603275,CDS,1,297,yqxD
5604,gene,2603372,2603867,gene,-1,495,yqxD
5605,CDS,2603372,2603867,CDS,-1,495,ppsR
5606,gene,2604120,2604933,gene,-1,813,ppsR
5607,CDS,2604120,2604933,CDS,-1,813,ccpN
5608,gene,2604958,2605597,gene,-1,639,ccpN
5609,CDS,2604958,2605597,CDS,-1,639,glyS
5610,gene,2605729,2607769,gene,-1,2040,glyS
5611,CDS,2605729,2607769,CDS,-1,2040,glyQ
5613,CDS,2607761,2608649,CDS,-1,888,tboG
5612,gene,2607761,2608649,gene,-1,888,glyQ
5614,gene,2608731,2608906,gene,-1,175,tboG
5615,misc_RNA,2608731,2608906,else,-1,175,recO
5616,gene,2608945,2609713,gene,-1,768,recO
5617,CDS,2608945,2609713,CDS,-1,768,yqzL
5618,gene,2609749,2609893,gene,-1,144,yqzL
5619,CDS,2609749,2609893,CDS,-1,144,era
5621,CDS,2610040,2610946,CDS,-1,906,cdd
5620,gene,2610040,2610946,gene,-1,906,era
5622,gene,2610926,2611337,gene,-1,411,cdd
5623,CDS,2610926,2611337,CDS,-1,411,unpK
5624,gene,2611455,2611827,gene,-1,372,unpK
5625,CDS,2611455,2611827,CDS,-1,372,rnrY
5626,gene,2611807,2612281,gene,-1,474,rnrY
5627,CDS,2611807,2612281,CDS,-1,474,pgpH
5628,gene,2612281,2614417,gene,-1,2136,pgpH
5629,CDS,2612281,2614417,CDS,-1,2136,phoH
5631,CDS,2614495,2615455,CDS,-1,960,yqfD
5630,gene,2614495,2615455,gene,-1,960,phoH
5632,gene,2615451,2616648,gene,-1,1197,yqfD
5633,CDS,2615451,2616648,CDS,-1,1197,yqfC
5634,gene,2616666,2616948,gene,-1,282,yqfC
5635,CDS,2616666,2616948,CDS,-1,282,yqfB
5636,gene,2617004,2617424,gene,-1,420,yqfB
5637,CDS,2617004,2617424,CDS,-1,420,floA
5639,CDS,2617448,2618444,CDS,-1,996,nfeDA
5638,gene,2617448,2618444,gene,-1,996,floA
5640,gene,2618465,2619779,gene,-1,1314,nfeDA
5641,CDS,2618465,2619779,CDS,-1,1314,yqeY
5642,gene,2619909,2620356,gene,-1,447,yqeY
5643,CDS,2619909,2620356,CDS,-1,447,rpsU
5644,gene,2620370,2620544,gene,-1,174,rpsU
5645,CDS,2620370,2620544,CDS,-1,174,yqeW
5646,gene,2620716,2621640,gene,1,924,yqeW
5647,CDS,2620716,2621640,CDS,1,924,mtaB
5649,CDS,2621676,2623032,CDS,-1,1356,rsmE
5648,gene,2621676,2623032,gene,-1,1356,mtaB
5650,gene,2623031,2623802,gene,-1,771,rsmE
5651,CDS,2623031,2623802,CDS,-1,771,prmA
5652,gene,2623824,2624760,gene,-1,936,prmA
5653,CDS,2623824,2624760,CDS,-1,936,dnaJ
5654,gene,2624784,2625912,gene,-1,1128,dnaJ
5655,CDS,2624784,2625912,CDS,-1,1128,surC
5656,gene,2625951,2626042,gene,1,91,surC
5657,misc_RNA,2625951,2626042,else,1,91,dnaK
5658,gene,2626111,2627947,gene,-1,1836,dnaK
5659,CDS,2626111,2627947,CDS,-1,1836,grpE
5660,gene,2627970,2628534,gene,-1,564,grpE
5661,CDS,2627970,2628534,CDS,-1,564,hrcA
5662,gene,2628605,2629637,gene,-1,1032,hrcA
5663,CDS,2628605,2629637,CDS,-1,1032,hemN
5664,gene,2629717,2630857,gene,-1,1140,hemN
5665,CDS,2629717,2630857,CDS,-1,1140,lepA
5666,gene,2630909,2632748,gene,-1,1839,lepA
5667,CDS,2630909,2632748,CDS,-1,1839,yqxA
5669,CDS,2632881,2633220,CDS,-1,339,spoIIP
5668,gene,2632881,2633220,gene,-1,339,yqxA
5671,CDS,2633236,2634442,CDS,-1,1206,gpr
5670,gene,2633236,2634442,gene,-1,1206,spoIIP
5672,gene,2634504,2635611,gene,-1,1107,gpr
5673,CDS,2634504,2635611,CDS,-1,1107,rpsT
5674,gene,2635814,2636081,gene,1,267,rpsT
5675,CDS,2635814,2636081,CDS,1,267,holA
5676,gene,2636095,2637139,gene,-1,1044,holA
5677,CDS,2636095,2637139,CDS,-1,1044,BSU_25565
5678,gene,2637178,2637328,gene,-1,150,BSU_25565
5679,CDS,2637178,2637328,CDS,-1,150,yqzM
5681,CDS,2637368,2637503,CDS,1,135,comEC
5680,gene,2637368,2637503,gene,1,135,yqzM
5682,gene,2637542,2639873,gene,-1,2331,comEC
5683,CDS,2637542,2639873,CDS,-1,2331,comEB
5684,gene,2639876,2640446,gene,-1,570,comEB
5685,CDS,2639876,2640446,CDS,-1,570,comEA
5686,gene,2640512,2641130,gene,-1,618,comEA
5687,CDS,2640512,2641130,CDS,-1,618,comER
5689,CDS,2641213,2642035,CDS,1,822,yqeM
5688,gene,2641213,2642035,gene,1,822,comER
5690,gene,2642100,2642844,gene,-1,744,yqeM
5691,CDS,2642100,2642844,CDS,-1,744,rsfS
5692,gene,2642840,2643197,gene,-1,357,rsfS
5693,CDS,2642840,2643197,CDS,-1,357,yqeK
5694,gene,2643214,2643775,gene,-1,561,yqeK
5695,CDS,2643214,2643775,CDS,-1,561,nadD
5696,gene,2643764,2644334,gene,-1,570,nadD
5697,CDS,2643764,2644334,CDS,-1,570,yqeI
5698,gene,2644345,2644636,gene,-1,291,yqeI
5699,CDS,2644345,2644636,CDS,-1,291,aroE
5700,gene,2644629,2645472,gene,-1,843,aroE
5701,CDS,2644629,2645472,CDS,-1,843,rgpH
5702,gene,2645489,2646590,gene,-1,1101,rgpH
5703,CDS,2645489,2646590,CDS,-1,1101,yqeG
5704,gene,2646593,2647112,gene,-1,519,yqeG
5705,CDS,2646593,2647112,CDS,-1,519,sdaM
5707,misc_RNA,2647404,2647663,else,-1,259,sda
5706,gene,2647404,2647663,gene,-1,259,sdaM
5708,gene,2647455,2647614,gene,1,159,sda
5709,CDS,2647455,2647614,CDS,1,159,yqeF
5710,gene,2647919,2648651,gene,-1,732,yqeF
5711,CDS,2647919,2648651,CDS,-1,732,cwlH
5712,gene,2648902,2649655,gene,-1,753,cwlH
5713,CDS,2648902,2649655,CDS,-1,753,yqeD
5715,CDS,2649841,2650468,CDS,1,627,yqeC
5714,gene,2649841,2650468,gene,1,627,yqeD
5716,gene,2650486,2651380,gene,-1,894,yqeC
5717,CDS,2650486,2651380,CDS,-1,894,yqeB
5718,gene,2651631,2652354,gene,1,723,yqeB
5719,CDS,2651631,2652354,CDS,1,723,nucB
5720,gene,2652386,2652797,gene,-1,411,nucB
5721,CDS,2652386,2652797,CDS,-1,411,sigKn
5722,gene,2652992,2653463,gene,1,471,sigKn
5723,misc_feature,2652992,2653463,else,1,471,spoIVCA
5725,CDS,2653370,2654873,CDS,-1,1503,arsC
5724,gene,2653370,2654873,gene,-1,1503,spoIVCA
5726,gene,2655321,2655741,gene,-1,420,arsC
5727,CDS,2655321,2655741,CDS,-1,420,arsB
5728,gene,2655752,2656793,gene,-1,1041,arsB
5729,CDS,2655752,2656793,CDS,-1,1041,yqcK
5730,gene,2656815,2657256,gene,-1,441,yqcK
5731,CDS,2656815,2657256,CDS,-1,441,arsR
5732,gene,2657316,2657634,gene,-1,318,arsR
5733,CDS,2657316,2657634,CDS,-1,318,yqcI
5734,gene,2658005,2658770,gene,-1,765,yqcI
5735,CDS,2658005,2658770,CDS,-1,765,rapE
5736,gene,2659212,2660340,gene,1,1128,rapE
5737,CDS,2659212,2660340,CDS,1,1128,phrE
5738,gene,2660329,2660464,gene,1,135,phrE
5739,CDS,2660329,2660464,CDS,1,135,yqzI
5741,CDS,2660573,2660732,CDS,1,159,rttG
5740,gene,2660573,2660732,gene,1,159,yqzI
5743,CDS,2661101,2662697,CDS,1,1596,rttF
5742,gene,2661101,2662697,gene,1,1596,rttG
5744,gene,2662711,2663290,gene,1,579,rttF
5745,CDS,2662711,2663290,CDS,1,579,BSU_25875
5746,gene,2663407,2663554,gene,1,147,BSU_25875
5747,CDS,2663407,2663554,CDS,1,147,yqxJ
5748,gene,2663550,2663913,gene,-1,363,yqxJ
5749,CDS,2663550,2663913,CDS,-1,363,yqxI
5750,gene,2663928,2664408,gene,-1,480,yqxI
5751,CDS,2663928,2664408,CDS,-1,480,cwlA
5752,gene,2664572,2665391,gene,-1,819,cwlA
5753,CDS,2664572,2665391,CDS,-1,819,yqxH
5754,gene,2665435,2665858,gene,-1,423,yqxH
5755,CDS,2665435,2665858,CDS,-1,423,yqxG
5756,gene,2665902,2666796,gene,-1,894,yqxG
5757,CDS,2665902,2666796,CDS,-1,894,yqcE
5758,gene,2666883,2667048,gene,-1,165,yqcE
5759,CDS,2666883,2667048,CDS,-1,165,yqcD
5761,CDS,2667044,2667380,CDS,-1,336,yqcC
5760,gene,2667044,2667380,gene,-1,336,yqcD
5762,gene,2667389,2668490,gene,-1,1101,yqcC
5763,CDS,2667389,2668490,CDS,-1,1101,yqcB
5764,gene,2668492,2668765,gene,-1,273,yqcB
5765,CDS,2668492,2668765,CDS,-1,273,yqcA
5766,gene,2668761,2669340,gene,-1,579,yqcA
5767,CDS,2668761,2669340,CDS,-1,579,yqbT
5769,CDS,2669323,2670370,CDS,-1,1047,yqbS
5768,gene,2669323,2670370,gene,-1,1047,yqbT
5770,gene,2670362,2670788,gene,-1,426,yqbS
5771,CDS,2670362,2670788,CDS,-1,426,yqbR
5772,gene,2670800,2671064,gene,-1,264,yqbR
5773,CDS,2670800,2671064,CDS,-1,264,yqbQ
5774,gene,2671060,2672041,gene,-1,981,yqbQ
5775,CDS,2671060,2672041,CDS,-1,981,yqbP
5777,CDS,2672053,2672713,CDS,-1,660,yqbO
5776,gene,2672053,2672713,gene,-1,660,yqbP
5779,CDS,2672705,2677463,CDS,-1,4758,yqbNc
5778,gene,2672705,2677463,gene,-1,4758,yqbO
5780,gene,2677465,2677657,gene,-1,192,yqbNc
5781,misc_feature,2677465,2677657,else,-1,192,yqbNn
5782,gene,2677656,2678094,gene,-1,438,yqbNn
5783,misc_feature,2677656,2678094,else,-1,438,txpA
5784,gene,2678239,2678419,gene,1,180,txpA
5785,CDS,2678239,2678419,CDS,1,180,ratA
5786,gene,2678342,2678565,gene,-1,223,ratA
5787,misc_RNA,2678342,2678565,else,-1,223,bsrH
5789,CDS,2678798,2678888,CDS,1,90,asrH
5788,gene,2678798,2678888,gene,1,90,bsrH
5790,gene,2678875,2679014,gene,-1,139,asrH
5791,misc_RNA,2678875,2679014,else,-1,139,yqbM
5792,gene,2679141,2679585,gene,-1,444,yqbM
5793,CDS,2679141,2679585,CDS,-1,444,yqbK
5794,gene,2679587,2680988,gene,-1,1401,yqbK
5795,CDS,2679587,2680988,CDS,-1,1401,yqzN
5797,CDS,2680988,2681180,CDS,-1,192,yqbJ
5796,gene,2680988,2681180,gene,-1,192,yqzN
5798,gene,2681176,2681614,gene,-1,438,yqbJ
5799,CDS,2681176,2681614,CDS,-1,438,yqbI
5800,gene,2681626,2682130,gene,-1,504,yqbI
5801,CDS,2681626,2682130,CDS,-1,504,yqbH
5802,gene,2682126,2682489,gene,-1,363,yqbH
5803,CDS,2682126,2682489,CDS,-1,363,yqbG
5804,gene,2682485,2682881,gene,-1,396,yqbG
5805,CDS,2682485,2682881,CDS,-1,396,yqbF
5806,gene,2682884,2683196,gene,-1,312,yqbF
5807,CDS,2682884,2683196,CDS,-1,312,yqbE
5808,gene,2683206,2684142,gene,-1,936,yqbE
5809,CDS,2683206,2684142,CDS,-1,936,yqbD
5810,gene,2684160,2685129,gene,-1,969,yqbD
5811,CDS,2684160,2685129,CDS,-1,969,yqbC
5813,CDS,2685161,2685815,CDS,-1,654,yqbB
5812,gene,2685161,2685815,gene,-1,654,yqbC
5814,gene,2685855,2686773,gene,-1,918,yqbB
5815,CDS,2685855,2686773,CDS,-1,918,yqbA
5816,gene,2686769,2688302,gene,-1,1533,yqbA
5817,CDS,2686769,2688302,CDS,-1,1533,yqaT
5818,gene,2688305,2689601,gene,-1,1296,yqaT
5819,CDS,2688305,2689601,CDS,-1,1296,yqaS
5820,gene,2689593,2690313,gene,-1,720,yqaS
5821,CDS,2689593,2690313,CDS,-1,720,yqaR
5822,gene,2690380,2690845,gene,-1,465,yqaR
5823,CDS,2690380,2690845,CDS,-1,465,yqaQ
5824,gene,2690988,2691444,gene,-1,456,yqaQ
5825,CDS,2690988,2691444,CDS,-1,456,yqaP
5826,gene,2691641,2692571,gene,1,930,yqaP
5827,CDS,2691641,2692571,CDS,1,930,yqaO
5829,CDS,2692644,2692851,CDS,-1,207,yqaN
5828,gene,2692644,2692851,gene,-1,207,yqaO
5830,gene,2692932,2693361,gene,-1,429,yqaN
5831,CDS,2692932,2693361,CDS,-1,429,yqzO
5832,gene,2693456,2693606,gene,-1,150,yqzO
5833,CDS,2693456,2693606,CDS,-1,150,sknM
5834,gene,2693596,2694538,gene,-1,942,sknM
5835,CDS,2693596,2694538,CDS,-1,942,yqaL
5837,CDS,2694419,2695097,CDS,-1,678,yqaK
5836,gene,2694419,2695097,gene,-1,678,yqaL
5838,gene,2695172,2696027,gene,-1,855,yqaK
5839,CDS,2695172,2696027,CDS,-1,855,yqaJ
5840,gene,2696029,2696989,gene,-1,960,yqaJ
5841,CDS,2696029,2696989,CDS,-1,960,yqaI
5842,gene,2697094,2697289,gene,-1,195,yqaI
5843,CDS,2697094,2697289,CDS,-1,195,BSU_26305
5844,gene,2697248,2697422,gene,-1,174,BSU_26305
5845,CDS,2697248,2697422,CDS,-1,174,sknH
5847,CDS,2697418,2697676,CDS,-1,258,yqaG
5846,gene,2697418,2697676,gene,-1,258,sknH
5848,gene,2697672,2698242,gene,-1,570,yqaG
5849,CDS,2697672,2698242,CDS,-1,570,yqdA
5850,gene,2698315,2698456,gene,-1,141,yqdA
5851,CDS,2698315,2698456,CDS,-1,141,yqaF
5852,gene,2698485,2698716,gene,-1,231,yqaF
5853,CDS,2698485,2698716,CDS,-1,231,sknR
5855,CDS,2698892,2699243,CDS,1,351,yqaD
5854,gene,2698892,2699243,gene,1,351,sknR
5856,gene,2699509,2699677,gene,-1,168,yqaD
5857,CDS,2699509,2699677,CDS,-1,168,yqaC
5858,gene,2700032,2700569,gene,-1,537,yqaC
5859,CDS,2700032,2700569,CDS,-1,537,yqaB
5860,gene,2700837,2701356,gene,1,519,yqaB
5861,CDS,2700837,2701356,CDS,1,519,sigKc
5862,gene,2701337,2701754,gene,1,417,sigKc
5863,misc_feature,2701337,2701754,else,1,417,BSU_26399
5865,CDS,2701753,2701870,CDS,1,117,yrkS
5864,gene,2701753,2701870,gene,1,117,BSU_26399
5866,gene,2701978,2702143,gene,-1,165,yrkS
5867,CDS,2701978,2702143,CDS,-1,165,psiE
5868,gene,2702687,2703104,gene,-1,417,psiE
5869,CDS,2702687,2703104,CDS,-1,417,yrkQ
5870,gene,2703149,2704448,gene,-1,1299,yrkQ
5871,CDS,2703149,2704448,CDS,-1,1299,yrkP
5872,gene,2704434,2705130,gene,-1,696,yrkP
5873,CDS,2704434,2705130,CDS,-1,696,yrkO
5874,gene,2705397,2706615,gene,1,1218,yrkO
5875,CDS,2705397,2706615,CDS,1,1218,BSU_26449
5876,gene,2706533,2706782,gene,1,249,BSU_26449
5877,CDS,2706533,2706782,CDS,1,249,yrkN
5878,gene,2707126,2707684,gene,1,558,yrkN
5879,CDS,2707126,2707684,CDS,1,558,yrkL
5880,gene,2708174,2708699,gene,-1,525,yrkL
5881,CDS,2708174,2708699,CDS,-1,525,yrkK
5883,CDS,2708942,2709419,CDS,-1,477,yrkJ
5882,gene,2708942,2709419,gene,-1,477,yrkK
5884,gene,2710001,2710787,gene,-1,786,yrkJ
5885,CDS,2710001,2710787,CDS,-1,786,yrkI
5886,gene,2710847,2711075,gene,-1,228,yrkI
5887,CDS,2710847,2711075,CDS,-1,228,yrkH
5888,gene,2711108,2712242,gene,-1,1134,yrkH
5889,CDS,2711108,2712242,CDS,-1,1134,yrkF
5891,CDS,2712576,2713134,CDS,-1,558,yrkE
5890,gene,2712576,2713134,gene,-1,558,yrkF
5892,gene,2713319,2713802,gene,-1,483,yrkE
5893,CDS,2713319,2713802,CDS,-1,483,yrkD
5894,gene,2713948,2714140,gene,-1,192,yrkD
5895,CDS,2713948,2714140,CDS,-1,192,yrzM
5896,gene,2714230,2714548,gene,-1,318,yrzM
5897,misc_feature,2714230,2714548,else,-1,318,yrzN
5899,misc_feature,2714589,2714805,else,-1,216,yrkC
5898,gene,2714589,2714805,gene,-1,216,yrzN
5901,CDS,2714932,2715493,CDS,-1,561,BSU_26569
5900,gene,2714932,2715493,gene,-1,561,yrkC
5902,gene,2715509,2715686,gene,-1,177,BSU_26569
5903,CDS,2715509,2715686,CDS,-1,177,yrkB
5904,gene,2715718,2715865,gene,-1,147,yrkB
5905,CDS,2715718,2715865,CDS,-1,147,bltR
5906,gene,2716034,2716856,gene,-1,822,bltR
5907,CDS,2716034,2716856,CDS,-1,822,blt
5908,gene,2716972,2718175,gene,1,1203,blt
5909,CDS,2716972,2718175,CDS,1,1203,bltD
5911,CDS,2718343,2718802,CDS,1,459,yrkA
5910,gene,2718343,2718802,gene,1,459,bltD
5912,gene,2718958,2720263,gene,-1,1305,yrkA
5913,CDS,2718958,2720263,CDS,-1,1305,yrzO
5914,gene,2720525,2720669,gene,-1,144,yrzO
5915,CDS,2720525,2720669,CDS,-1,144,yrdR
5916,gene,2720686,2721652,gene,-1,966,yrdR
5917,CDS,2720686,2721652,CDS,-1,966,czcR
5919,CDS,2721777,2722644,CDS,1,867,yrdP
5918,gene,2721777,2722644,gene,1,867,czcR
5920,gene,2722766,2723804,gene,-1,1038,yrdP
5921,CDS,2722766,2723804,CDS,-1,1038,czcD
5922,gene,2723891,2724827,gene,-1,936,czcD
5923,CDS,2723891,2724827,CDS,-1,936,yrdN
5924,gene,2725113,2725503,gene,-1,390,yrdN
5925,CDS,2725113,2725503,CDS,-1,390,gltR
5926,gene,2725836,2726727,gene,1,891,gltR
5927,CDS,2725836,2726727,CDS,1,891,yrdK
5928,gene,2726884,2727202,gene,-1,318,yrdK
5929,CDS,2726884,2727202,CDS,-1,318,brnQ
5930,gene,2727159,2728482,gene,-1,1323,brnQ
5931,CDS,2727159,2728482,CDS,-1,1323,azlD
5932,gene,2728646,2728979,gene,-1,333,azlD
5933,CDS,2728646,2728979,CDS,-1,333,azlC
5935,CDS,2728975,2729740,CDS,-1,765,azlB
5934,gene,2728975,2729740,gene,-1,765,azlC
5936,gene,2729752,2730226,gene,-1,474,azlB
5937,CDS,2729752,2730226,CDS,-1,474,yrdF
5938,gene,2730559,2730835,gene,-1,276,yrdF
5939,CDS,2730559,2730835,CDS,-1,276,cypA
5940,gene,2731106,2732339,gene,-1,1233,cypA
5941,CDS,2731106,2732339,CDS,-1,1233,yrdDc
5943,misc_feature,2732388,2732547,else,-1,159,yrdDm
5942,gene,2732388,2732547,gene,-1,159,yrdDc
5944,gene,2732546,2732747,gene,-1,201,yrdDm
5945,misc_feature,2732546,2732747,else,-1,201,yrdDn
5946,gene,2732746,2732881,gene,-1,135,yrdDn
5947,misc_feature,2732746,2732881,else,-1,135,yrdC
5948,gene,2732979,2733543,gene,-1,564,yrdC
5949,CDS,2732979,2733543,CDS,-1,564,yrdB
5950,gene,2733771,2734143,gene,-1,372,yrdB
5951,CDS,2733771,2734143,CDS,-1,372,yrdA
5952,gene,2734952,2735456,gene,-1,504,yrdA
5953,CDS,2734952,2735456,CDS,-1,504,aadK
5955,CDS,2735681,2736536,CDS,-1,855,yrpB
5954,gene,2735681,2736536,gene,-1,855,aadK
5956,gene,2736914,2737958,gene,1,1044,yrpB
5957,CDS,2736914,2737958,CDS,1,1044,murI
5958,gene,2738307,2739105,gene,1,798,murI
5959,CDS,2738307,2739105,CDS,1,798,yrpD
5960,gene,2739485,2740193,gene,1,708,yrpD
5961,CDS,2739485,2740193,CDS,1,708,BSU_26829
5962,gene,2740516,2740678,gene,1,162,BSU_26829
5963,misc_feature,2740516,2740678,else,1,162,yrpDX
5964,gene,2740768,2740846,gene,1,78,yrpDX
5965,CDS,2740768,2740846,CDS,1,78,BSU_26827
5966,gene,2741132,2741294,gene,-1,162,BSU_26827
5967,CDS,2741132,2741294,CDS,-1,162,zinT
5968,gene,2741356,2742112,gene,-1,756,zinT
5969,CDS,2741356,2742112,CDS,-1,756,sigZ
5971,CDS,2742243,2742774,CDS,-1,531,yrpG
5970,gene,2742243,2742774,gene,-1,531,sigZ
5972,gene,2742908,2743889,gene,1,981,yrpG
5973,CDS,2742908,2743889,CDS,1,981,yraO
5974,gene,2744162,2745479,gene,-1,1317,yraO
5975,CDS,2744162,2745479,CDS,-1,1317,yraN
5976,gene,2745593,2746463,gene,-1,870,yraN
5977,CDS,2745593,2746463,CDS,-1,870,prpF
5979,CDS,2746607,2747711,CDS,1,1104,csn
5978,gene,2746607,2747711,gene,1,1104,prpF
5980,gene,2747983,2748817,gene,-1,834,csn
5981,CDS,2747983,2748817,CDS,-1,834,yraL
5982,gene,2749259,2749523,gene,1,264,yraL
5983,CDS,2749259,2749523,CDS,1,264,yraK
5984,gene,2749659,2750475,gene,1,816,yraK
5985,CDS,2749659,2750475,CDS,1,816,yraJ
5986,gene,2750882,2751239,gene,-1,357,yraJ
5987,CDS,2750882,2751239,CDS,-1,357,yraI
5989,CDS,2751291,2751651,CDS,-1,360,BSU_26935
5988,gene,2751291,2751651,gene,-1,360,yraI
5990,gene,2751922,2752024,gene,-1,102,BSU_26935
5991,CDS,2751922,2752024,CDS,-1,102,yraH
5992,gene,2752166,2752553,gene,-1,387,yraH
5993,CDS,2752166,2752553,CDS,-1,387,yraG
5994,gene,2752801,2753047,gene,1,246,yraG
5995,CDS,2752801,2753047,CDS,1,246,yraF
5997,CDS,2753064,2753433,CDS,1,369,adhB
5996,gene,2753064,2753433,gene,1,369,yraF
5998,gene,2753451,2754588,gene,1,1137,adhB
5999,CDS,2753451,2754588,CDS,1,1137,yraE
6000,gene,2754606,2754804,gene,1,198,yraE
6001,CDS,2754606,2754804,CDS,1,198,yraD
6002,gene,2754819,2755119,gene,1,300,yraD
6003,CDS,2754819,2755119,CDS,1,300,adhR
6004,gene,2755381,2755804,gene,-1,423,adhR
6005,CDS,2755381,2755804,CDS,-1,423,yrzP
6007,CDS,2755986,2756181,CDS,1,195,adhA
6006,gene,2755986,2756181,gene,1,195,yrzP
6008,gene,2756311,2757361,gene,1,1050,adhA
6009,CDS,2756311,2757361,CDS,1,1050,sufL
6010,gene,2757491,2758001,gene,1,510,sufL
6011,CDS,2757491,2758001,CDS,1,510,sacC
6012,gene,2758042,2760076,gene,-1,2034,sacC
6013,CDS,2758042,2760076,CDS,-1,2034,BSU_27035
6014,gene,2759984,2760152,gene,-1,168,BSU_27035
6015,CDS,2759984,2760152,CDS,-1,168,levG
6016,gene,2760232,2761060,gene,-1,828,levG
6017,CDS,2760232,2761060,CDS,-1,828,levF
6018,gene,2761080,2761890,gene,-1,810,levF
6019,CDS,2761080,2761890,CDS,-1,810,levE
6020,gene,2761906,2762395,gene,-1,489,levE
6021,CDS,2761906,2762395,CDS,-1,489,levD
6022,gene,2762394,2762835,gene,-1,441,levD
6023,CDS,2762394,2762835,CDS,-1,441,levR
6025,CDS,2763024,2765832,CDS,-1,2808,BSU_27085
6024,gene,2763024,2765832,gene,-1,2808,levR
6026,gene,2766378,2766519,gene,1,141,BSU_27085
6027,CDS,2766378,2766519,CDS,1,141,aapA
6028,gene,2766557,2767946,gene,1,1389,aapA
6029,CDS,2766557,2767946,CDS,1,1389,yrhP
6030,gene,2768041,2768674,gene,-1,633,yrhP
6031,CDS,2768041,2768674,CDS,-1,633,yrhO
6033,CDS,2768826,2769654,CDS,1,828,sigV
6032,gene,2768826,2769654,gene,1,828,yrhO
6034,gene,2769849,2770350,gene,1,501,sigV
6035,CDS,2769849,2770350,CDS,1,501,rsiV
6036,gene,2770349,2771207,gene,1,858,rsiV
6037,CDS,2770349,2771207,CDS,1,858,oatA
6038,gene,2771317,2773222,gene,1,1905,oatA
6039,CDS,2771317,2773222,CDS,1,1905,yrhK
6041,CDS,2773355,2773646,CDS,1,291,surF
6040,gene,2773355,2773646,gene,1,291,yrhK
6043,misc_RNA,2773782,2773883,else,1,101,cypB
6042,gene,2773782,2773883,gene,1,101,surF
6044,gene,2773889,2777054,gene,-1,3165,cypB
6045,CDS,2773889,2777054,CDS,-1,3165,bscR
6046,gene,2777069,2777654,gene,-1,585,bscR
6047,CDS,2777069,2777654,CDS,-1,585,yrhH
6048,gene,2777876,2778419,gene,-1,543,yrhH
6049,CDS,2777876,2778419,CDS,-1,543,BSU_27185
6050,gene,2778607,2778766,gene,-1,159,BSU_27185
6051,CDS,2778607,2778766,CDS,-1,159,yrzI
6053,CDS,2778922,2779072,CDS,-1,150,yrhG
6052,gene,2778922,2779072,gene,-1,150,yrzI
6054,gene,2779461,2780262,gene,-1,801,yrhG
6055,CDS,2779461,2780262,CDS,-1,801,yrhF
6056,gene,2780524,2780893,gene,-1,369,yrhF
6057,CDS,2780524,2780893,CDS,-1,369,yrhE
6058,gene,2781208,2784151,gene,1,2943,yrhE
6059,CDS,2781208,2784151,CDS,1,2943,yrhD
6061,CDS,2784169,2784652,CDS,1,483,yrhC
6060,gene,2784169,2784652,gene,1,483,yrhD
6062,gene,2784687,2784918,gene,-1,231,yrhC
6063,CDS,2784687,2784918,CDS,-1,231,mccB
6064,gene,2785000,2786140,gene,-1,1140,mccB
6065,CDS,2785000,2786140,CDS,-1,1140,mccA
6066,gene,2786141,2787065,gene,-1,924,mccA
6067,CDS,2786141,2787065,CDS,-1,924,mtnN
6068,gene,2787129,2787825,gene,-1,696,mtnN
6069,CDS,2787129,2787825,CDS,-1,696,yrrT
6070,gene,2787845,2788487,gene,-1,642,yrrT
6071,CDS,2787845,2788487,CDS,-1,642,yrzA
6072,gene,2788679,2788883,gene,1,204,yrzA
6073,CDS,2788679,2788883,CDS,1,204,yrrS
6074,gene,2788919,2789621,gene,-1,702,yrrS
6075,CDS,2788919,2789621,CDS,-1,702,pbpI
6077,CDS,2789685,2791440,CDS,-1,1755,greA
6076,gene,2789685,2791440,gene,-1,1755,pbpI
6078,gene,2791493,2791967,gene,-1,474,greA
6079,CDS,2791493,2791967,CDS,-1,474,udk
6080,gene,2792217,2792853,gene,-1,636,udk
6081,CDS,2792217,2792853,CDS,-1,636,yrrO
6082,gene,2792859,2794128,gene,-1,1269,yrrO
6083,CDS,2792859,2794128,CDS,-1,1269,yrrN
6085,CDS,2794146,2795076,CDS,-1,930,yrrM
6084,gene,2794146,2795076,gene,-1,930,yrrN
6086,gene,2795081,2795735,gene,-1,654,yrrM
6087,CDS,2795081,2795735,CDS,-1,654,yrrL
6088,gene,2795886,2796969,gene,-1,1083,yrrL
6089,CDS,2795886,2796969,CDS,-1,1083,yrzB
6090,gene,2797099,2797381,gene,-1,282,yrzB
6091,CDS,2797099,2797381,CDS,-1,282,rimF
6092,gene,2797398,2797815,gene,-1,417,rimF
6093,CDS,2797398,2797815,CDS,-1,417,yrzL
6095,CDS,2797822,2798089,CDS,-1,267,alaS
6094,gene,2797822,2798089,gene,-1,267,yrzL
6097,CDS,2798173,2800810,CDS,-1,2637,tboA
6096,gene,2798173,2800810,gene,-1,2637,alaS
6098,gene,2800889,2801097,gene,-1,208,tboA
6099,misc_RNA,2800889,2801097,else,-1,208,yrrI
6100,gene,2801140,2802202,gene,-1,1062,yrrI
6101,CDS,2801140,2802202,CDS,-1,1062,glnQ
6102,gene,2802357,2803086,gene,1,729,glnQ
6103,CDS,2802357,2803086,CDS,1,729,glnH
6104,gene,2803107,2803929,gene,1,822,glnH
6105,CDS,2803107,2803929,CDS,1,822,glnM
6106,gene,2803989,2804640,gene,1,651,glnM
6107,CDS,2803989,2804640,CDS,1,651,glnP
6108,gene,2804656,2805313,gene,1,657,glnP
6109,CDS,2804656,2805313,CDS,1,657,yrzQ
6110,gene,2805347,2805479,gene,-1,132,yrzQ
6111,CDS,2805347,2805479,CDS,-1,132,yrzR
6112,gene,2805500,2805692,gene,-1,192,yrzR
6113,CDS,2805500,2805692,CDS,-1,192,yrrD
6115,CDS,2805703,2806228,CDS,-1,525,recDB
6114,gene,2805703,2806228,gene,-1,525,yrrD
6116,gene,2806285,2808682,gene,-1,2397,recDB
6117,CDS,2806285,2808682,CDS,-1,2397,yrrB
6118,gene,2808706,2809327,gene,-1,621,yrrB
6119,CDS,2808706,2809327,CDS,-1,621,mnmA
6120,gene,2809412,2810528,gene,-1,1116,mnmA
6121,CDS,2809412,2810528,CDS,-1,1116,iscSA
6123,CDS,2810558,2811698,CDS,-1,1140,cymR
6122,gene,2810558,2811698,gene,-1,1140,iscSA
6124,gene,2811716,2812133,gene,-1,417,cymR
6125,CDS,2811716,2812133,CDS,-1,417,rarA
6126,gene,2812335,2813601,gene,1,1266,rarA
6127,CDS,2812335,2813601,CDS,1,1266,tcdA
6128,gene,2813642,2814407,gene,-1,765,tcdA
6129,CDS,2813642,2814407,CDS,-1,765,ssrSB
6131,misc_RNA,2814490,2814691,else,-1,201,aspS
6130,gene,2814490,2814691,gene,-1,201,ssrSB
6133,CDS,2814742,2816521,CDS,-1,1779,hisS
6132,gene,2814742,2816521,gene,-1,1779,aspS
6134,gene,2816534,2817809,gene,-1,1275,hisS
6135,CDS,2816534,2817809,CDS,-1,1275,tboH
6136,gene,2817898,2818131,gene,-1,233,tboH
6137,misc_RNA,2817898,2818131,else,-1,233,yrzK
6138,gene,2818190,2818361,gene,-1,171,yrzK
6139,CDS,2818190,2818361,CDS,-1,171,yrvJ
6140,gene,2818493,2820050,gene,1,1557,yrvJ
6141,CDS,2818493,2820050,CDS,1,1557,dtd
6143,CDS,2820076,2820475,CDS,-1,399,rsh
6142,gene,2820076,2820475,gene,-1,399,dtd
6144,gene,2820528,2822733,gene,-1,2205,rsh
6145,CDS,2820528,2822733,CDS,-1,2205,apt
6146,gene,2822900,2823413,gene,-1,513,apt
6147,CDS,2822900,2823413,CDS,-1,513,recJ
6148,gene,2823418,2825779,gene,-1,2361,recJ
6149,CDS,2823418,2825779,CDS,-1,2361,yrvD
6151,CDS,2825845,2826169,CDS,-1,324,yrvC
6150,gene,2825845,2826169,gene,-1,324,yrvD
6152,gene,2826244,2826742,gene,-1,498,yrvC
6153,CDS,2826244,2826742,CDS,-1,498,secDF
6154,gene,2826899,2829113,gene,-1,2214,secDF
6155,CDS,2826899,2829113,CDS,-1,2214,comN
6156,gene,2829151,2829448,gene,-1,297,comN
6157,CDS,2829151,2829448,CDS,-1,297,spoVB
6158,gene,2829563,2831120,gene,1,1557,spoVB
6159,CDS,2829563,2831120,CDS,1,1557,yrbG
6160,gene,2831123,2831780,gene,-1,657,yrbG
6161,CDS,2831123,2831780,CDS,-1,657,yrzE
6162,gene,2831914,2832367,gene,1,453,yrzE
6163,CDS,2831914,2832367,CDS,1,453,yrbF
6164,gene,2832423,2832690,gene,-1,267,yrbF
6165,CDS,2832423,2832690,CDS,-1,267,tgt
6167,CDS,2832726,2833872,CDS,-1,1146,queA
6166,gene,2832726,2833872,gene,-1,1146,tgt
6168,gene,2833898,2834927,gene,-1,1029,queA
6169,CDS,2833898,2834927,CDS,-1,1029,yrzS
6170,gene,2834956,2835157,gene,-1,201,yrzS
6171,CDS,2834956,2835157,CDS,-1,201,ruvB
6172,gene,2835149,2836154,gene,-1,1005,ruvB
6173,CDS,2835149,2836154,CDS,-1,1005,ruvA
6174,gene,2836164,2836770,gene,-1,606,ruvA
6175,CDS,2836164,2836770,CDS,-1,606,bofC
6176,gene,2836908,2837421,gene,-1,513,bofC
6177,CDS,2836908,2837421,CDS,-1,513,csbX
6178,gene,2837468,2838776,gene,-1,1308,csbX
6179,CDS,2837468,2838776,CDS,-1,1308,yrbE
6180,gene,2838846,2839872,gene,-1,1026,yrbE
6181,CDS,2838846,2839872,CDS,-1,1026,yrzF
6183,CDS,2840109,2840757,CDS,1,648,BSU_27786
6182,gene,2840109,2840757,gene,1,648,yrzF
6184,gene,2840802,2840925,gene,-1,123,BSU_27786
6185,CDS,2840802,2840925,CDS,-1,123,yrzH
6186,gene,2841009,2841300,gene,1,291,yrzH
6187,CDS,2841009,2841300,CDS,1,291,yrzT
6188,gene,2841306,2841447,gene,1,141,yrzT
6189,CDS,2841306,2841447,CDS,1,141,alaP
6191,CDS,2841610,2843065,CDS,1,1455,yrbC
6190,gene,2841610,2843065,gene,1,1455,alaP
6192,gene,2843105,2843828,gene,-1,723,yrbC
6193,CDS,2843105,2843828,CDS,-1,723,sgpA
6194,gene,2843930,2844527,gene,-1,597,sgpA
6195,CDS,2843930,2844527,CDS,-1,597,safA
6196,gene,2844674,2845838,gene,-1,1164,safA
6197,CDS,2844674,2845838,CDS,-1,1164,nadA
6198,gene,2845954,2847061,gene,-1,1107,nadA
6199,CDS,2845954,2847061,CDS,-1,1107,nadC
6201,CDS,2847047,2847917,CDS,-1,870,nadB
6200,gene,2847047,2847917,gene,-1,870,nadC
6202,gene,2847870,2849466,gene,-1,1596,nadB
6203,CDS,2847870,2849466,CDS,-1,1596,nifS
6204,gene,2849568,2850756,gene,1,1188,nifS
6205,CDS,2849568,2850756,CDS,1,1188,niaR
6206,gene,2850715,2851258,gene,1,543,niaR
6207,CDS,2850715,2851258,CDS,1,543,pheA
6209,CDS,2851282,2852140,CDS,-1,858,thrR
6208,gene,2851282,2852140,gene,-1,858,pheA
6210,gene,2852156,2852600,gene,-1,444,thrR
6211,CDS,2852156,2852600,CDS,-1,444,obgE
6212,gene,2852660,2853947,gene,-1,1287,obgE
6213,CDS,2852660,2853947,CDS,-1,1287,spo0B
6214,gene,2853980,2854559,gene,-1,579,spo0B
6215,CDS,2853980,2854559,CDS,-1,579,BSU_27935
6216,gene,2854636,2854759,gene,1,123,BSU_27935
6217,CDS,2854636,2854759,CDS,1,123,rpmA
6219,CDS,2854879,2855164,CDS,-1,285,rppA
6218,gene,2854879,2855164,gene,-1,285,rpmA
6220,gene,2855176,2855515,gene,-1,339,rppA
6221,CDS,2855176,2855515,CDS,-1,339,rplU
6222,gene,2855517,2855826,gene,-1,309,rplU
6223,CDS,2855517,2855826,CDS,-1,309,ldlU
6224,gene,2855839,2855915,gene,-1,76,ldlU
6225,misc_RNA,2855839,2855915,else,-1,76,spoIVFB
6226,gene,2855972,2856839,gene,-1,867,spoIVFB
6227,CDS,2855972,2856839,CDS,-1,867,spoIVFA
6228,gene,2856831,2857626,gene,-1,795,spoIVFA
6229,CDS,2856831,2857626,CDS,-1,795,minD
6230,gene,2857775,2858582,gene,-1,807,minD
6231,CDS,2857775,2858582,CDS,-1,807,minC
6232,gene,2858583,2859264,gene,-1,681,minC
6233,CDS,2858583,2859264,CDS,-1,681,mreD
6234,gene,2859316,2859835,gene,-1,519,mreD
6235,CDS,2859316,2859835,CDS,-1,519,mreC
6237,CDS,2859831,2860704,CDS,-1,873,mreB
6236,gene,2859831,2860704,gene,-1,873,mreC
6239,CDS,2860734,2861748,CDS,-1,1014,ysxA
6238,gene,2860734,2861748,gene,-1,1014,mreB
6240,gene,2861839,2862535,gene,-1,696,ysxA
6241,CDS,2861839,2862535,CDS,-1,696,maf
6242,gene,2862571,2863141,gene,-1,570,maf
6243,CDS,2862571,2863141,CDS,-1,570,spoIIB
6244,gene,2863293,2864292,gene,-1,999,spoIIB
6245,CDS,2863293,2864292,CDS,-1,999,comC
6246,gene,2864425,2865172,gene,-1,747,comC
6247,CDS,2864425,2865172,CDS,-1,747,folC
6248,gene,2865311,2866604,gene,-1,1293,folC
6249,CDS,2865311,2866604,CDS,-1,1293,valS
6250,gene,2866663,2869306,gene,-1,2643,valS
6251,CDS,2866663,2869306,CDS,-1,2643,tboV
6252,gene,2869365,2869588,gene,-1,223,tboV
6253,misc_RNA,2869365,2869588,else,-1,223,yszA
6255,CDS,2869753,2869945,CDS,1,192,cotN
6254,gene,2869753,2869945,gene,1,192,yszA
6256,gene,2869963,2870989,gene,-1,1026,cotN
6257,CDS,2869963,2870989,CDS,-1,1026,spoVID
6258,gene,2871021,2872749,gene,-1,1728,spoVID
6259,CDS,2871021,2872749,CDS,-1,1728,hemL
6260,gene,2872879,2874172,gene,-1,1293,hemL
6261,CDS,2872879,2874172,CDS,-1,1293,hemB
6263,CDS,2874201,2875176,CDS,-1,975,hemD
6262,gene,2874201,2875176,gene,-1,975,hemB
6264,gene,2875172,2875961,gene,-1,789,hemD
6265,CDS,2875172,2875961,CDS,-1,789,hemC
6266,gene,2875950,2876895,gene,-1,945,hemC
6267,CDS,2875950,2876895,CDS,-1,945,hemX
6268,gene,2876927,2877758,gene,-1,831,hemX
6269,CDS,2876927,2877758,CDS,-1,831,hemA
6270,gene,2877765,2879133,gene,-1,1368,hemA
6271,CDS,2877765,2879133,CDS,-1,1368,ysxD
6273,CDS,2879362,2879860,CDS,1,498,engB
6272,gene,2879362,2879860,gene,1,498,ysxD
6274,gene,2879881,2880469,gene,-1,588,engB
6275,CDS,2879881,2880469,CDS,-1,588,lonA
6276,gene,2880465,2882790,gene,-1,2325,lonA
6277,CDS,2880465,2882790,CDS,-1,2325,lonB
6278,gene,2882970,2884629,gene,-1,1659,lonB
6279,CDS,2882970,2884629,CDS,-1,1659,clpX
6281,CDS,2884780,2886043,CDS,-1,1263,tig
6280,gene,2884780,2886043,gene,-1,1263,clpX
6282,gene,2886314,2887589,gene,-1,1275,tig
6283,CDS,2886314,2887589,CDS,-1,1275,ysoA
6284,gene,2887816,2888821,gene,-1,1005,ysoA
6285,CDS,2887816,2888821,CDS,-1,1005,leuD
6286,gene,2888939,2889539,gene,-1,600,leuD
6287,CDS,2888939,2889539,CDS,-1,600,leuC
6288,gene,2889551,2890970,gene,-1,1419,leuC
6289,CDS,2889551,2890970,CDS,-1,1419,leuB
6291,CDS,2891019,2892117,CDS,-1,1098,leuA
6290,gene,2891019,2892117,gene,-1,1098,leuB
6292,gene,2892137,2893694,gene,-1,1557,leuA
6293,CDS,2892137,2893694,CDS,-1,1557,ilvC
6294,gene,2893680,2894709,gene,-1,1029,ilvC
6295,CDS,2893680,2894709,CDS,-1,1029,ilvH
6296,gene,2894732,2895251,gene,-1,519,ilvH
6297,CDS,2894732,2895251,CDS,-1,519,ilvB
6298,gene,2895247,2896972,gene,-1,1725,ilvB
6299,CDS,2895247,2896972,CDS,-1,1725,tboILV
6300,gene,2897093,2897340,gene,-1,247,tboILV
6301,misc_RNA,2897093,2897340,else,-1,247,cotQ
6302,gene,2897787,2898123,gene,1,336,cotQ
6303,CDS,2897787,2898123,CDS,1,336,ysnE
6304,gene,2898291,2898747,gene,1,456,ysnE
6305,CDS,2898291,2898747,CDS,1,456,ysnF
6306,gene,2898930,2899752,gene,1,822,ysnF
6307,CDS,2898930,2899752,CDS,1,822,trnSL-Arg2
6309,tRNA,2899815,2899889,else,-1,74,ysnB
6308,gene,2899815,2899889,gene,-1,74,trnSL-Arg2
6310,gene,2900019,2900529,gene,-1,510,ysnB
6311,CDS,2900019,2900529,CDS,-1,510,rdgB
6312,gene,2900544,2901141,gene,-1,597,rdgB
6313,CDS,2900544,2901141,CDS,-1,597,rph
6314,gene,2901153,2901891,gene,-1,738,rph
6315,CDS,2901153,2901891,CDS,-1,738,gerM
6317,CDS,2902001,2903102,CDS,-1,1101,rcmE
6316,gene,2902001,2903102,gene,-1,1101,gerM
6318,gene,2903216,2904035,gene,-1,819,rcmE
6319,CDS,2903216,2904035,CDS,-1,819,ysmB
6320,gene,2904042,2904483,gene,-1,441,ysmB
6321,CDS,2904042,2904483,CDS,-1,441,gerE
6322,gene,2904726,2904951,gene,-1,225,gerE
6323,CDS,2904726,2904951,CDS,-1,225,ysmA
6325,CDS,2905066,2905510,CDS,-1,444,sdhB
6324,gene,2905066,2905510,gene,-1,444,ysmA
6327,CDS,2905570,2906332,CDS,-1,762,sdhA
6326,gene,2905570,2906332,gene,-1,762,sdhB
6328,gene,2906334,2908095,gene,-1,1761,sdhA
6329,CDS,2906334,2908095,CDS,-1,1761,sdhC
6330,gene,2908128,2908737,gene,-1,609,sdhC
6331,CDS,2908128,2908737,CDS,-1,609,yslB
6332,gene,2909029,2909476,gene,1,447,yslB
6333,CDS,2909029,2909476,CDS,1,447,lysCA
6337,CDS,2909519,2910011,CDS,-1,492,kswC
6336,gene,2909519,2910011,gene,-1,492,lysCB
6334,gene,2909519,2910746,gene,-1,1227,lysCA
6335,CDS,2909519,2910746,CDS,-1,1227,lysCB
6338,gene,2910871,2911051,gene,-1,180,kswC
6339,misc_RNA,2910871,2911051,else,-1,180,uvrC
6340,gene,2911115,2912888,gene,-1,1773,uvrC
6341,CDS,2911115,2912888,CDS,-1,1773,trxA
6342,gene,2913023,2913338,gene,-1,315,trxA
6343,CDS,2913023,2913338,CDS,-1,315,BSU_28509
6345,misc_feature,2913482,2913593,else,-1,111,abfB
6344,gene,2913482,2913593,gene,-1,111,BSU_28509
6346,gene,2913660,2915148,gene,-1,1488,abfB
6347,CDS,2913660,2915148,CDS,-1,1488,etfA
6348,gene,2915364,2916342,gene,-1,978,etfA
6349,CDS,2915364,2916342,CDS,-1,978,etfB
6350,gene,2916377,2917151,gene,-1,774,etfB
6351,CDS,2916377,2917151,CDS,-1,774,fadB
6352,gene,2917165,2917942,gene,-1,777,fadB
6353,CDS,2917165,2917942,CDS,-1,777,fadR
6354,gene,2917956,2918541,gene,-1,585,fadR
6355,CDS,2917956,2918541,CDS,-1,585,lcfA
6356,gene,2918645,2920328,gene,-1,1683,lcfA
6357,CDS,2918645,2920328,CDS,-1,1683,yshE
6358,gene,2920516,2920921,gene,-1,405,yshE
6359,CDS,2920516,2920921,CDS,-1,405,mutSB
6361,CDS,2920935,2923293,CDS,-1,2358,polX
6360,gene,2920935,2923293,gene,-1,2358,mutSB
6362,gene,2923313,2925026,gene,-1,1713,polX
6363,CDS,2923313,2925026,CDS,-1,1713,yshB
6364,gene,2925099,2925633,gene,-1,534,yshB
6365,CDS,2925099,2925633,CDS,-1,534,zapA
6366,gene,2925639,2925897,gene,-1,258,zapA
6367,CDS,2925639,2925897,CDS,-1,258,rnhC
6369,CDS,2926030,2926972,CDS,1,942,pheT
6368,gene,2926030,2926972,gene,1,942,rnhC
6370,gene,2927007,2929422,gene,-1,2415,pheT
6371,CDS,2927007,2929422,CDS,-1,2415,pheS
6372,gene,2929437,2930472,gene,-1,1035,pheS
6373,CDS,2929437,2930472,CDS,-1,1035,BSU_28645
6374,gene,2930553,2930760,gene,1,207,BSU_28645
6375,CDS,2930553,2930760,CDS,1,207,rlmBB
6376,gene,2930826,2931573,gene,-1,747,rlmBB
6377,CDS,2930826,2931573,CDS,-1,747,sspI
6378,gene,2931691,2931907,gene,1,216,sspI
6379,CDS,2931691,2931907,CDS,1,216,ysfB
6381,CDS,2931975,2933082,CDS,1,1107,glcD
6380,gene,2931975,2933082,gene,1,1107,ysfB
6382,gene,2933184,2934597,gene,1,1413,glcD
6383,CDS,2933184,2934597,CDS,1,1413,glcF
6384,gene,2934593,2935928,gene,1,1335,glcF
6385,CDS,2934593,2935928,CDS,1,1335,ysfE
6386,gene,2935966,2936209,gene,-1,243,ysfE
6387,CDS,2935966,2936209,CDS,-1,243,BSU_28709
6388,gene,2936268,2936439,gene,-1,171,BSU_28709
6389,CDS,2936268,2936439,CDS,-1,171,cstA
6390,gene,2936381,2938178,gene,-1,1797,cstA
6391,CDS,2936381,2938178,CDS,-1,1797,abfA
6392,gene,2938329,2939832,gene,-1,1503,abfA
6393,CDS,2938329,2939832,CDS,-1,1503,araQ
6394,gene,2939850,2940696,gene,-1,846,araQ
6395,CDS,2939850,2940696,CDS,-1,846,araP
6397,CDS,2940696,2941638,CDS,-1,942,araN
6396,gene,2940696,2941638,gene,-1,942,araP
6398,gene,2941673,2942975,gene,-1,1302,araN
6399,CDS,2941673,2942975,CDS,-1,1302,egsA
6400,gene,2943005,2944190,gene,-1,1185,egsA
6401,CDS,2943005,2944190,CDS,-1,1185,araL
6402,gene,2944186,2945005,gene,-1,819,araL
6403,CDS,2944186,2945005,CDS,-1,819,araD
6405,CDS,2944982,2945672,CDS,-1,690,araB
6404,gene,2944982,2945672,gene,-1,690,araD
6406,gene,2945688,2947371,gene,-1,1683,araB
6407,CDS,2945688,2947371,CDS,-1,1683,araA
6408,gene,2947384,2948875,gene,-1,1491,araA
6409,CDS,2947384,2948875,CDS,-1,1491,abnA
6410,gene,2949052,2950024,gene,-1,972,abnA
6411,CDS,2949052,2950024,CDS,-1,972,frvX
6412,gene,2950220,2951306,gene,-1,1086,frvX
6413,CDS,2950220,2951306,CDS,-1,1086,ysdB
6415,CDS,2951489,2951882,CDS,1,393,ysdA
6414,gene,2951489,2951882,gene,1,393,ysdB
6416,gene,2951897,2952167,gene,-1,270,ysdA
6417,CDS,2951897,2952167,CDS,-1,270,rplT
6418,gene,2952223,2952583,gene,-1,360,rplT
6419,CDS,2952223,2952583,CDS,-1,360,rpmI
6420,gene,2952614,2952815,gene,-1,201,rpmI
6421,CDS,2952614,2952815,CDS,-1,201,infC
6423,CDS,2952827,2953349,CDS,-1,522,BSU_misc_RNA_47
6422,gene,2952827,2953349,gene,-1,522,infC
6424,gene,2953410,2953550,gene,-1,140,BSU_misc_RNA_47
6425,misc_RNA,2953410,2953550,else,-1,140,yscB
6426,gene,2953794,2954460,gene,1,666,yscB
6427,CDS,2953794,2954460,CDS,1,666,pftB
6428,gene,2954491,2955187,gene,-1,696,pftB
6429,CDS,2954491,2955187,CDS,-1,696,pftA
6430,gene,2955208,2955649,gene,-1,441,pftA
6431,CDS,2955208,2955649,CDS,-1,441,lytT
6433,CDS,2955782,2956508,CDS,-1,726,lytS
6432,gene,2955782,2956508,gene,-1,726,lytT
6434,gene,2956485,2958267,gene,-1,1782,lytS
6435,CDS,2956485,2958267,CDS,-1,1782,ysaA
6436,gene,2958433,2959216,gene,1,783,ysaA
6437,CDS,2958433,2959216,CDS,1,783,thrS
6438,gene,2959256,2961188,gene,-1,1932,thrS
6439,CDS,2959256,2961188,CDS,-1,1932,tboT
6440,gene,2961231,2961479,gene,-1,248,tboT
6441,misc_RNA,2961231,2961479,else,-1,248,ytxC
6442,gene,2961585,2962431,gene,-1,846,ytxC
6443,CDS,2961585,2962431,CDS,-1,846,ytxB
6444,gene,2962509,2963151,gene,-1,642,ytxB
6445,CDS,2962509,2963151,CDS,-1,642,dnaI
6446,gene,2963184,2964120,gene,-1,936,dnaI
6447,CDS,2963184,2964120,CDS,-1,936,dnaB
6449,CDS,2964147,2965566,CDS,-1,1419,nrdR
6448,gene,2964147,2965566,gene,-1,1419,dnaB
6451,CDS,2965680,2966139,CDS,-1,459,speD
6450,gene,2965680,2966139,gene,-1,459,nrdR
6452,gene,2966412,2966793,gene,-1,381,speD
6453,CDS,2966412,2966793,CDS,-1,381,gapB
6454,gene,2967031,2968054,gene,-1,1023,gapB
6455,CDS,2967031,2968054,CDS,-1,1023,ytcD
6456,gene,2968259,2968640,gene,-1,381,ytcD
6457,CDS,2968259,2968640,CDS,-1,381,ytbD
6458,gene,2968823,2970014,gene,1,1191,ytbD
6459,CDS,2968823,2970014,CDS,1,1191,ytbE
6460,gene,2970037,2970880,gene,1,843,ytbE
6461,CDS,2970037,2970880,CDS,1,843,coaE
6462,gene,2970921,2971515,gene,-1,594,coaE
6463,CDS,2970921,2971515,CDS,-1,594,spcF
6464,gene,2971530,2972163,gene,-1,633,spcF
6465,CDS,2971530,2972163,CDS,-1,633,mutM
6467,CDS,2972328,2973159,CDS,-1,831,polA
6466,gene,2972328,2973159,gene,-1,831,mutM
6468,gene,2973181,2975824,gene,-1,2643,polA
6469,CDS,2973181,2975824,CDS,-1,2643,phoR
6470,gene,2976067,2977807,gene,-1,1740,phoR
6471,CDS,2976067,2977807,CDS,-1,1740,phoP
6472,gene,2977799,2978522,gene,-1,723,phoP
6473,CDS,2977799,2978522,CDS,-1,723,mdh
6475,CDS,2978733,2979672,CDS,-1,939,icd
6474,gene,2978733,2979672,gene,-1,939,mdh
6476,gene,2979715,2980987,gene,-1,1272,icd
6477,CDS,2979715,2980987,CDS,-1,1272,citZ
6478,gene,2981150,2982269,gene,-1,1119,citZ
6479,CDS,2981150,2982269,CDS,-1,1119,ytwI
6480,gene,2982602,2983067,gene,-1,465,ytwI
6481,CDS,2982602,2983067,CDS,-1,465,ytvI
6482,gene,2983163,2984279,gene,1,1116,ytvI
6483,CDS,2983163,2984279,CDS,1,1116,ytzA
6485,CDS,2984311,2984695,CDS,-1,384,pyk
6484,gene,2984311,2984695,gene,-1,384,ytzA
6486,gene,2984787,2986545,gene,-1,1758,pyk
6487,CDS,2984787,2986545,CDS,-1,1758,pfkA
6488,gene,2986587,2987547,gene,-1,960,pfkA
6489,CDS,2986587,2987547,CDS,-1,960,accA
6490,gene,2987730,2988708,gene,-1,978,accA
6491,CDS,2987730,2988708,CDS,-1,978,accD
6493,CDS,2988692,2989565,CDS,-1,873,maeB
6492,gene,2988692,2989565,gene,-1,873,accD
6494,gene,2989899,2991132,gene,-1,1233,maeB
6495,CDS,2989899,2991132,CDS,-1,1233,dnaEC
6496,gene,2991268,2994616,gene,-1,3348,dnaEC
6497,CDS,2991268,2994616,CDS,-1,3348,ytrH
6498,gene,2994755,2995097,gene,1,342,ytrH
6499,CDS,2994755,2995097,CDS,1,342,ytrI
6500,gene,2995093,2995597,gene,1,504,ytrI
6501,CDS,2995093,2995597,CDS,1,504,ytzJ
6503,CDS,2995698,2995890,CDS,1,192,nrnA
6502,gene,2995698,2995890,gene,1,192,ytzJ
6504,gene,2995907,2996849,gene,-1,942,nrnA
6505,CDS,2995907,2996849,CDS,-1,942,ytpI
6506,gene,2996979,2997282,gene,1,303,ytpI
6507,CDS,2996979,2997282,CDS,1,303,ytoI
6508,gene,2997300,2998620,gene,-1,1320,ytoI
6509,CDS,2997300,2998620,CDS,-1,1320,ytnM
6510,gene,2998795,2999698,gene,-1,903,ytnM
6511,CDS,2998795,2999698,CDS,-1,903,sndA
6512,gene,2999716,3000967,gene,-1,1251,sndA
6513,CDS,2999716,3000967,CDS,-1,1251,ribR
6514,gene,3000984,3001677,gene,-1,693,ribR
6515,CDS,3000984,3001677,CDS,-1,693,cmoJ
6516,gene,3001723,3003052,gene,-1,1329,cmoJ
6517,CDS,3001723,3003052,CDS,-1,1329,cmoI
6518,gene,3003048,3003330,gene,-1,282,cmoI
6519,CDS,3003048,3003330,CDS,-1,282,cmoO
6521,CDS,3003344,3004349,CDS,-1,1005,tcyN
6520,gene,3003344,3004349,gene,-1,1005,cmoO
6523,CDS,3004345,3005125,CDS,-1,780,tcyM
6522,gene,3004345,3005125,gene,-1,780,tcyN
6524,gene,3005121,3005829,gene,-1,708,tcyM
6525,CDS,3005121,3005829,CDS,-1,708,tcyL
6526,gene,3005858,3006578,gene,-1,720,tcyL
6527,CDS,3005858,3006578,CDS,-1,720,tcyK
6528,gene,3006599,3007412,gene,-1,813,tcyK
6529,CDS,3006599,3007412,CDS,-1,813,tcyJ
6530,gene,3007425,3008235,gene,-1,810,tcyJ
6531,CDS,3007425,3008235,CDS,-1,810,snaA
6533,CDS,3008248,3008785,CDS,-1,537,ascR
6532,gene,3008248,3008785,gene,-1,537,snaA
6534,gene,3008937,3009864,gene,1,927,ascR
6535,CDS,3008937,3009864,CDS,1,927,ytkL
6536,gene,3009914,3010598,gene,-1,684,ytkL
6537,CDS,3009914,3010598,CDS,-1,684,ytkK
6538,gene,3010660,3011428,gene,-1,768,ytkK
6539,CDS,3010660,3011428,CDS,-1,768,ytzD
6541,CDS,3011554,3011791,CDS,-1,237,argH
6540,gene,3011554,3011791,gene,-1,237,ytzD
6542,gene,3011750,3013136,gene,-1,1386,argH
6543,CDS,3011750,3013136,CDS,-1,1386,argG
6544,gene,3013132,3014344,gene,-1,1212,argG
6545,CDS,3013132,3014344,CDS,-1,1212,moaB
6546,gene,3014513,3015026,gene,-1,513,moaB
6547,CDS,3014513,3015026,CDS,-1,513,ackA
6548,gene,3015110,3016298,gene,-1,1188,ackA
6549,CDS,3015110,3016298,CDS,-1,1188,BSU_29479
6550,gene,3016470,3016674,gene,-1,204,BSU_29479
6551,CDS,3016470,3016674,CDS,-1,204,ytxK
6552,gene,3016645,3017635,gene,-1,990,ytxK
6553,CDS,3016645,3017635,CDS,-1,990,tpx
6554,gene,3017695,3018199,gene,-1,504,tpx
6555,CDS,3017695,3018199,CDS,-1,504,gerW
6556,gene,3018308,3018764,gene,-1,456,gerW
6557,CDS,3018308,3018764,CDS,-1,456,ytfI
6559,CDS,3018777,3019458,CDS,-1,681,yteJ
6558,gene,3018777,3019458,gene,-1,681,ytfI
6560,gene,3019532,3020027,gene,-1,495,yteJ
6561,CDS,3019532,3020027,CDS,-1,495,sppA
6562,gene,3020039,3021047,gene,-1,1008,sppA
6563,CDS,3020039,3021047,CDS,-1,1008,ppnKB
6564,gene,3021232,3022036,gene,1,804,ppnKB
6565,CDS,3021232,3022036,CDS,1,804,ytcJ
6567,CDS,3022067,3023657,CDS,-1,1590,ytcI
6566,gene,3022067,3023657,gene,-1,1590,ytcJ
6568,gene,3023676,3025266,gene,-1,1590,ytcI
6569,CDS,3023676,3025266,CDS,-1,1590,sspA
6570,gene,3025444,3025654,gene,-1,210,sspA
6571,CDS,3025444,3025654,CDS,-1,210,trmG
6572,gene,3025747,3026953,gene,-1,1206,trmG
6573,CDS,3025747,3026953,CDS,-1,1206,iscSB
6574,gene,3026956,3028102,gene,-1,1146,iscSB
6575,CDS,3026956,3028102,CDS,-1,1146,braB
6577,CDS,3028296,3029634,CDS,1,1338,ezrA
6576,gene,3028296,3029634,gene,1,1338,braB
6578,gene,3029728,3031417,gene,-1,1689,ezrA
6579,CDS,3029728,3031417,CDS,-1,1689,hisK
6580,gene,3031613,3032420,gene,1,807,hisK
6581,CDS,3031613,3032420,CDS,1,807,refZ
6582,gene,3032416,3033040,gene,-1,624,refZ
6583,CDS,3032416,3033040,CDS,-1,624,msrC
6584,gene,3033166,3033658,gene,1,492,msrC
6585,CDS,3033166,3033658,CDS,1,492,dgcP
6586,gene,3033695,3035435,gene,-1,1740,dgcP
6587,CDS,3033695,3035435,CDS,-1,1740,ldsD
6588,gene,3035588,3035721,gene,1,133,ldsD
6589,misc_RNA,3035588,3035721,else,1,133,rpsD
6590,gene,3035729,3036332,gene,1,603,rpsD
6591,CDS,3035729,3036332,CDS,1,603,tyrS
6593,CDS,3036602,3037871,CDS,-1,1269,tboY
6592,gene,3036602,3037871,gene,-1,1269,tyrS
6595,misc_RNA,3037894,3038168,else,-1,274,acsA
6594,gene,3037894,3038168,gene,-1,274,tboY
6596,gene,3038212,3039931,gene,-1,1719,acsA
6597,CDS,3038212,3039931,CDS,-1,1719,acuA
6598,gene,3040091,3040724,gene,1,633,acuA
6599,CDS,3040091,3040724,CDS,1,633,acuB
6600,gene,3040750,3041395,gene,1,645,acuB
6601,CDS,3040750,3041395,CDS,1,645,acuC
6602,gene,3041391,3042555,gene,1,1164,acuC
6603,CDS,3041391,3042555,CDS,1,1164,motS
6604,gene,3042565,3043294,gene,-1,729,motS
6605,CDS,3042565,3043294,CDS,-1,729,motP
6606,gene,3043283,3044102,gene,-1,819,motP
6607,CDS,3043283,3044102,CDS,-1,819,ccpA
6608,gene,3044164,3045169,gene,-1,1005,ccpA
6609,CDS,3044164,3045169,CDS,-1,1005,aroX
6610,gene,3045444,3046521,gene,-1,1077,aroX
6611,CDS,3045444,3046521,CDS,-1,1077,brxJ
6613,CDS,3046756,3047083,CDS,-1,327,ytxH
6612,gene,3046756,3047083,gene,-1,327,brxJ
6614,gene,3047106,3047562,gene,-1,456,ytxH
6615,CDS,3047106,3047562,CDS,-1,456,ytxG
6616,gene,3047592,3048015,gene,-1,423,ytxG
6617,CDS,3047592,3048015,CDS,-1,423,murC
6618,gene,3048176,3049475,gene,-1,1299,murC
6619,CDS,3048176,3049475,CDS,-1,1299,sftA
6621,CDS,3049724,3052583,CDS,-1,2859,ytpR
6620,gene,3049724,3052583,gene,-1,2859,sftA
6622,gene,3052742,3053348,gene,-1,606,ytpR
6623,CDS,3052742,3053348,CDS,-1,606,ytpQ
6624,gene,3053363,3054173,gene,-1,810,ytpQ
6625,CDS,3053363,3054173,CDS,-1,810,ytpP
6626,gene,3054187,3054511,gene,-1,324,ytpP
6627,CDS,3054187,3054511,CDS,-1,324,BSU_29845
6629,CDS,3054549,3054666,CDS,-1,117,ytoQ
6628,gene,3054549,3054666,gene,-1,117,BSU_29845
6631,CDS,3054745,3055192,CDS,1,447,ytoP
6630,gene,3054745,3055192,gene,1,447,ytoQ
6632,gene,3055246,3056320,gene,-1,1074,ytoP
6633,CDS,3055246,3056320,CDS,-1,1074,ytzB
6634,gene,3056478,3056796,gene,1,318,ytzB
6635,CDS,3056478,3056796,CDS,1,318,maeC
6636,gene,3056848,3058549,gene,-1,1701,maeC
6637,CDS,3056848,3058549,CDS,-1,1701,ytnP
6638,gene,3058630,3059401,gene,-1,771,ytnP
6639,CDS,3058630,3059401,CDS,-1,771,trmB
6641,CDS,3059546,3060188,CDS,-1,642,ytzH
6640,gene,3059546,3060188,gene,-1,642,trmB
6642,gene,3060394,3060673,gene,1,279,ytzH
6643,CDS,3060394,3060673,CDS,1,279,ytmP
6644,gene,3060673,3061288,gene,-1,615,ytmP
6645,CDS,3060673,3061288,CDS,-1,615,amyX
6646,gene,3061650,3063807,gene,-1,2157,amyX
6647,CDS,3061650,3063807,CDS,-1,2157,ytlR
6649,CDS,3063832,3064762,CDS,-1,930,ytlQ
6648,gene,3063832,3064762,gene,-1,930,ytlR
6650,gene,3064810,3065725,gene,-1,915,ytlQ
6651,CDS,3064810,3065725,CDS,-1,915,ytlP
6652,gene,3065750,3066302,gene,-1,552,ytlP
6653,CDS,3065750,3066302,CDS,-1,552,ytkP
6654,gene,3066450,3067386,gene,1,936,ytkP
6655,CDS,3066450,3067386,CDS,1,936,ytjP
6656,gene,3067419,3068811,gene,-1,1392,ytjP
6657,CDS,3067419,3068811,CDS,-1,1392,pbuO
6658,gene,3068907,3070206,gene,1,1299,pbuO
6659,CDS,3068907,3070206,CDS,1,1299,ythQ
6660,gene,3070245,3071403,gene,-1,1158,ythQ
6661,CDS,3070245,3071403,CDS,-1,1158,ythP
6662,gene,3071399,3072110,gene,-1,711,ythP
6663,CDS,3071399,3072110,CDS,-1,711,ytzE
6665,CDS,3072400,3072622,CDS,1,222,rsuA
6664,gene,3072400,3072622,gene,1,222,ytzE
6666,gene,3072742,3073462,gene,-1,720,rsuA
6667,CDS,3072742,3073462,CDS,-1,720,murJ
6668,gene,3073530,3075165,gene,-1,1635,murJ
6669,CDS,3073530,3075165,CDS,-1,1635,ytfP
6670,gene,3075366,3076629,gene,1,1263,ytfP
6671,CDS,3075366,3076629,CDS,1,1263,opuD
6672,gene,3076817,3078356,gene,1,1539,opuD
6673,CDS,3076817,3078356,CDS,1,1539,yteV
6674,gene,3078392,3078575,gene,-1,183,yteV
6675,CDS,3078392,3078575,CDS,-1,183,rmgU
6676,gene,3078642,3079311,gene,-1,669,rmgU
6677,CDS,3078642,3079311,CDS,-1,669,rmgT
6678,gene,3079332,3080619,gene,-1,1287,rmgT
6679,CDS,3079332,3080619,CDS,-1,1287,rmgS
6681,CDS,3080630,3081134,CDS,-1,504,rmgQ
6680,gene,3080630,3081134,gene,-1,504,rmgS
6682,gene,3081130,3082252,gene,-1,1122,rmgQ
6683,CDS,3081130,3082252,CDS,-1,1122,rmgP
6684,gene,3082259,3083225,gene,-1,966,rmgP
6685,CDS,3082259,3083225,CDS,-1,966,rmgR
6686,gene,3083440,3085759,gene,1,2319,rmgR
6687,CDS,3083440,3085759,CDS,1,2319,ytcQ
6689,CDS,3085799,3087296,CDS,-1,1497,ytcP
6688,gene,3085799,3087296,gene,-1,1497,ytcQ
6690,gene,3087320,3088181,gene,-1,861,ytcP
6691,CDS,3087320,3088181,CDS,-1,861,ytbQ
6692,gene,3088387,3089149,gene,-1,762,ytbQ
6693,CDS,3088387,3089149,CDS,-1,762,bioI
6694,gene,3089225,3090413,gene,-1,1188,bioI
6695,CDS,3089225,3090413,CDS,-1,1188,bioB
6696,gene,3090481,3091489,gene,-1,1008,bioB
6697,CDS,3090481,3091489,CDS,-1,1008,bioD
6699,CDS,3091491,3092187,CDS,-1,696,bioFC
6698,gene,3091491,3092187,gene,-1,696,bioD
6700,gene,3092183,3093353,gene,-1,1170,bioFC
6701,CDS,3092183,3093353,CDS,-1,1170,bioK
6702,gene,3093342,3094689,gene,-1,1347,bioK
6703,CDS,3093342,3094689,CDS,-1,1347,bioW
6704,gene,3094678,3095455,gene,-1,777,bioW
6705,CDS,3094678,3095455,CDS,-1,777,ytaP
6707,CDS,3095664,3096564,CDS,-1,900,msmR
6706,gene,3095664,3096564,gene,-1,900,ytaP
6708,gene,3096781,3097816,gene,1,1035,msmR
6709,CDS,3096781,3097816,CDS,1,1035,msmE
6710,gene,3097849,3099130,gene,1,1281,msmE
6711,CDS,3097849,3099130,CDS,1,1281,msmF
6712,gene,3099122,3100034,gene,1,912,msmF
6713,CDS,3099122,3100034,CDS,1,912,msmG
6714,gene,3100030,3100861,gene,1,831,msmG
6715,CDS,3100030,3100861,CDS,1,831,melA
6717,CDS,3100880,3102179,CDS,1,1299,ytwF
6716,gene,3100880,3102179,gene,1,1299,melA
6718,gene,3102200,3102512,gene,-1,312,ytwF
6719,CDS,3102200,3102512,CDS,-1,312,leuS
6720,gene,3102628,3105043,gene,-1,2415,leuS
6721,CDS,3102628,3105043,CDS,-1,2415,tboL
6722,gene,3105152,3105367,gene,-1,215,tboL
6723,misc_RNA,3105152,3105367,else,-1,215,ytvB
6724,gene,3105469,3105805,gene,-1,336,ytvB
6725,CDS,3105469,3105805,CDS,-1,336,blrA
6726,gene,3106209,3106995,gene,1,786,blrA
6727,CDS,3106209,3106995,CDS,1,786,yttB
6728,gene,3107231,3108425,gene,-1,1194,yttB
6729,CDS,3107231,3108425,CDS,-1,1194,yttA
6730,gene,3108613,3109360,gene,1,747,yttA
6731,CDS,3108613,3109360,CDS,1,747,bceB
6732,gene,3109396,3111337,gene,-1,1941,bceB
6733,CDS,3109396,3111337,CDS,-1,1941,bceA
6735,CDS,3111326,3112088,CDS,-1,762,bceS
6734,gene,3111326,3112088,gene,-1,762,bceA
6736,gene,3112189,3113194,gene,-1,1005,bceS
6737,CDS,3112189,3113194,CDS,-1,1005,bceR
6738,gene,3113186,3113882,gene,-1,696,bceR
6739,CDS,3113186,3113882,CDS,-1,696,ytrF
6740,gene,3113978,3115289,gene,-1,1311,ytrF
6741,CDS,3113978,3115289,CDS,-1,1311,ytrE
6742,gene,3115278,3115974,gene,-1,696,ytrE
6743,CDS,3115278,3115974,CDS,-1,696,ytrD
6744,gene,3115988,3116966,gene,-1,978,ytrD
6745,CDS,3115988,3116966,CDS,-1,978,ytrC
6746,gene,3116995,3117982,gene,-1,987,ytrC
6747,CDS,3116995,3117982,CDS,-1,987,ytrB
6748,gene,3117975,3118854,gene,-1,879,ytrB
6749,CDS,3117975,3118854,CDS,-1,879,ytrA
6751,CDS,3118846,3119239,CDS,-1,393,BSU_30466
6750,gene,3118846,3119239,gene,-1,393,ytrA
6752,gene,3119272,3119410,gene,-1,138,BSU_30466
6753,CDS,3119272,3119410,CDS,-1,138,ytzC
6754,gene,3119564,3119837,gene,-1,273,ytzC
6755,CDS,3119564,3119837,CDS,-1,273,ytqA
6756,gene,3119998,3120967,gene,1,969,ytqA
6757,CDS,3119998,3120967,CDS,1,969,ytqB
6759,CDS,3120963,3121548,CDS,1,585,tbcS
6758,gene,3120963,3121548,gene,1,585,ytqB
6760,gene,3121537,3122641,gene,-1,1104,tbcS
6761,CDS,3121537,3122641,CDS,-1,1104,ytpA
6762,gene,3122661,3123441,gene,-1,780,ytpA
6763,CDS,3122661,3123441,CDS,-1,780,ytoA
6764,gene,3123489,3124005,gene,1,516,ytoA
6765,CDS,3123489,3124005,CDS,1,516,ytnA
6767,CDS,3124249,3125641,CDS,-1,1392,asnB
6766,gene,3124249,3125641,gene,-1,1392,ytnA
6769,CDS,3125776,3127675,CDS,-1,1899,metK
6768,gene,3125776,3127675,gene,-1,1899,asnB
6770,gene,3127824,3129027,gene,-1,1203,metK
6771,CDS,3127824,3129027,CDS,-1,1203,mswG
6772,gene,3129194,3129333,gene,-1,139,mswG
6773,misc_RNA,3129194,3129333,else,-1,139,pckA
6774,gene,3129529,3131113,gene,1,1584,pckA
6775,CDS,3129529,3131113,CDS,1,1584,ytmB
6776,gene,3131151,3131394,gene,-1,243,ytmB
6777,CDS,3131151,3131394,CDS,-1,243,ytmA
6778,gene,3131445,3132219,gene,-1,774,ytmA
6779,CDS,3131445,3132219,CDS,-1,774,ytlA
6780,gene,3132369,3133374,gene,1,1005,ytlA
6781,CDS,3132369,3133374,CDS,1,1005,ytlC
6782,gene,3133386,3134169,gene,1,783,ytlC
6783,CDS,3133386,3134169,CDS,1,783,ytlD
6785,CDS,3134143,3134956,CDS,1,813,rppG
6784,gene,3134143,3134956,gene,1,813,ytlD
6786,gene,3134982,3135459,gene,-1,477,rppG
6787,CDS,3134982,3135459,CDS,-1,477,ytkC
6788,gene,3135667,3136072,gene,-1,405,ytkC
6789,CDS,3135667,3136072,CDS,-1,405,dps
6790,gene,3136237,3136675,gene,-1,438,dps
6791,CDS,3136237,3136675,CDS,-1,438,ytzI
6793,CDS,3136767,3136944,CDS,1,177,ytkA
6792,gene,3136767,3136944,gene,1,177,ytzI
6794,gene,3136937,3137375,gene,-1,438,ytkA
6795,CDS,3136937,3137375,CDS,-1,438,luxS
6796,gene,3137494,3137968,gene,-1,474,luxS
6797,CDS,3137494,3137968,CDS,-1,474,ytjA
6798,gene,3138096,3138324,gene,1,228,ytjA
6799,CDS,3138096,3138324,CDS,1,228,ytiB
6800,gene,3138320,3138884,gene,-1,564,ytiB
6801,CDS,3138320,3138884,CDS,-1,564,rpmEB
6803,CDS,3138977,3139226,CDS,-1,249,ythA
6802,gene,3138977,3139226,gene,-1,249,rpmEB
6805,CDS,3139430,3140762,CDS,1,1332,ythB
6804,gene,3139430,3140762,gene,1,1332,ythA
6806,gene,3140805,3141846,gene,1,1041,ythB
6807,CDS,3140805,3141846,CDS,1,1041,ytzL
6808,gene,3141899,3142058,gene,1,159,ytzL
6809,CDS,3141899,3142058,CDS,1,159,mntD
6810,gene,3142076,3142964,gene,-1,888,mntD
6811,CDS,3142076,3142964,CDS,-1,888,mntC
6812,gene,3142953,3144261,gene,-1,1308,mntC
6813,CDS,3142953,3144261,CDS,-1,1308,mntB
6815,CDS,3144266,3145019,CDS,-1,753,mntA
6814,gene,3144266,3145019,gene,-1,753,mntB
6816,gene,3145037,3145958,gene,-1,921,mntA
6817,CDS,3145037,3145958,CDS,-1,921,menC
6818,gene,3146237,3147353,gene,-1,1116,menC
6819,CDS,3146237,3147353,CDS,-1,1116,menE
6820,gene,3147349,3148810,gene,-1,1461,menE
6821,CDS,3147349,3148810,CDS,-1,1461,menB
6823,CDS,3148900,3149716,CDS,-1,816,menH
6822,gene,3148900,3149716,gene,-1,816,menB
6824,gene,3149750,3150575,gene,-1,825,menH
6825,CDS,3149750,3150575,CDS,-1,825,menD
6826,gene,3150562,3152305,gene,-1,1743,menD
6827,CDS,3150562,3152305,CDS,-1,1743,menF
6828,gene,3152301,3153717,gene,-1,1416,menF
6829,CDS,3152301,3153717,CDS,-1,1416,yteA
6830,gene,3154006,3154726,gene,1,720,yteA
6831,CDS,3154006,3154726,CDS,1,720,ytdA
6832,gene,3154734,3155553,gene,-1,819,ytdA
6833,CDS,3154734,3155553,CDS,-1,819,ytcA
6834,gene,3155724,3157011,gene,1,1287,ytcA
6835,CDS,3155724,3157011,CDS,1,1287,ytcB
6836,gene,3157007,3157958,gene,1,951,ytcB
6837,CDS,3157007,3157958,CDS,1,951,ytcC
6838,gene,3157960,3159184,gene,1,1224,ytcC
6839,CDS,3157960,3159184,CDS,1,1224,cotOO
6841,CDS,3159257,3159689,CDS,-1,432,cotS
6840,gene,3159257,3159689,gene,-1,432,cotOO
6842,gene,3159690,3160746,gene,-1,1056,cotS
6843,CDS,3159690,3160746,CDS,-1,1056,cotSA
6844,gene,3160760,3161894,gene,-1,1134,cotSA
6845,CDS,3160760,3161894,CDS,-1,1134,cotI
6846,gene,3162083,3163157,gene,1,1074,cotI
6847,CDS,3162083,3163157,CDS,1,1074,ytaB
6849,CDS,3163236,3163704,CDS,1,468,glgP
6848,gene,3163236,3163704,gene,1,468,ytaB
6850,gene,3163734,3166131,gene,-1,2397,glgP
6851,CDS,3163734,3166131,CDS,-1,2397,glgA
6852,gene,3166117,3167572,gene,-1,1455,glgA
6853,CDS,3166117,3167572,CDS,-1,1455,glgD
6854,gene,3167568,3168600,gene,-1,1032,glgD
6855,CDS,3167568,3168600,CDS,-1,1032,glgC
6856,gene,3168623,3169766,gene,-1,1143,glgC
6857,CDS,3168623,3169766,CDS,-1,1143,glgB
6859,CDS,3169762,3171646,CDS,-1,1884,trnB-Glu
6858,gene,3169762,3171646,gene,-1,1884,glgB
6860,gene,3171878,3171950,gene,-1,72,trnB-Glu
6861,tRNA,3171878,3171950,else,-1,72,trnB-Ser2
6862,gene,3171975,3172066,gene,-1,91,trnB-Ser2
6863,tRNA,3171975,3172066,else,-1,91,trnB-Asn
6864,gene,3172069,3172144,gene,-1,75,trnB-Asn
6865,tRNA,3172069,3172144,else,-1,75,trnB-Ile2
6866,gene,3172154,3172231,gene,-1,77,trnB-Ile2
6867,tRNA,3172154,3172231,else,-1,77,trnB-Gly2
6868,gene,3172246,3172320,gene,-1,74,trnB-Gly2
6869,tRNA,3172246,3172320,else,-1,74,trnB-His
6870,gene,3172330,3172406,gene,-1,76,trnB-His
6871,tRNA,3172330,3172406,else,-1,76,trnB-Phe
6872,gene,3172423,3172499,gene,-1,76,trnB-Phe
6873,tRNA,3172423,3172499,else,-1,76,trnB-Asp
6875,tRNA,3172511,3172588,else,-1,77,trnB-Met2
6874,gene,3172511,3172588,gene,-1,77,trnB-Asp
6877,tRNA,3172599,3172676,else,-1,77,trnB-Ser1
6876,gene,3172599,3172676,gene,-1,77,trnB-Met2
6878,gene,3172693,3172786,gene,-1,93,trnB-Ser1
6879,tRNA,3172693,3172786,else,-1,93,trnB-Met3
6880,gene,3172792,3172869,gene,-1,77,trnB-Met3
6881,tRNA,3172792,3172869,else,-1,77,trnB-Met1
6882,gene,3172871,3172948,gene,-1,77,trnB-Met1
6883,tRNA,3172871,3172948,else,-1,77,trnB-Ala
6884,gene,3172967,3173040,gene,-1,73,trnB-Ala
6885,tRNA,3172967,3173040,else,-1,73,trnB-Pro
6886,gene,3173045,3173122,gene,-1,77,trnB-Pro
6887,tRNA,3173045,3173122,else,-1,77,trnB-Arg
6888,gene,3173137,3173214,gene,-1,77,trnB-Arg
6889,tRNA,3173137,3173214,else,-1,77,trnB-Leu2
6890,gene,3173223,3173309,gene,-1,86,trnB-Leu2
6891,tRNA,3173223,3173309,else,-1,86,trnB-Gly1
6892,gene,3173323,3173398,gene,-1,75,trnB-Gly1
6893,tRNA,3173323,3173398,else,-1,75,trnB-Leu1
6895,tRNA,3173403,3173490,else,-1,87,trnB-Lys
6894,gene,3173403,3173490,gene,-1,87,trnB-Leu1
6896,gene,3173500,3173576,gene,-1,76,trnB-Lys
6897,tRNA,3173500,3173576,else,-1,76,trnB-Thr
6898,gene,3173613,3173689,gene,-1,76,trnB-Thr
6899,tRNA,3173613,3173689,else,-1,76,trnB-Val
6900,gene,3173721,3173797,gene,-1,76,trnB-Val
6901,tRNA,3173721,3173797,else,-1,76,rrnB-5S
6903,rRNA,3173817,3173935,else,-1,118,rrnB-23S
6902,gene,3173817,3173935,gene,-1,118,rrnB-5S
6904,gene,3173990,3176918,gene,-1,2928,rrnB-23S
6905,rRNA,3173990,3176918,else,-1,2928,rrnB-16S
6906,gene,3177085,3178640,gene,-1,1555,rrnB-16S
6907,rRNA,3177085,3178640,else,-1,1555,tswC
6908,gene,3179104,3179206,gene,1,102,tswC
6909,misc_RNA,3179104,3179206,else,1,102,thiT
6911,CDS,3179305,3179884,CDS,1,579,yuaI
6910,gene,3179305,3179884,gene,1,579,thiT
6913,CDS,3179925,3180447,CDS,-1,522,floT
6912,gene,3179925,3180447,gene,-1,522,yuaI
6914,gene,3180464,3181994,gene,-1,1530,floT
6915,CDS,3180464,3181994,CDS,-1,1530,nfeDB
6916,gene,3182014,3182539,gene,-1,525,nfeDB
6917,CDS,3182014,3182539,CDS,-1,525,yuaE
6918,gene,3182706,3183195,gene,1,489,yuaE
6919,CDS,3182706,3183195,CDS,1,489,yuaD
6920,gene,3183200,3183779,gene,-1,579,yuaD
6921,CDS,3183200,3183779,CDS,-1,579,gbsB
6923,CDS,3183866,3185075,CDS,-1,1209,gbsA
6922,gene,3183866,3185075,gene,-1,1209,gbsB
6924,gene,3185091,3186564,gene,-1,1473,gbsA
6925,CDS,3185091,3186564,CDS,-1,1473,gbsR
6926,gene,3186762,3187305,gene,1,543,gbsR
6927,CDS,3186762,3187305,CDS,1,543,bslA
6928,gene,3187502,3188048,gene,1,546,bslA
6929,CDS,3187502,3188048,CDS,1,546,swdA
6931,misc_RNA,3188172,3188341,else,1,169,ktrA
6930,gene,3188172,3188341,gene,1,169,swdA
6932,gene,3188413,3189082,gene,1,669,ktrA
6933,CDS,3188413,3189082,CDS,1,669,ktrB
6934,gene,3189088,3190426,gene,1,1338,ktrB
6935,CDS,3189088,3190426,CDS,1,1338,yubF
6936,gene,3190461,3190725,gene,-1,264,yubF
6937,CDS,3190461,3190725,CDS,-1,264,lytG
6938,gene,3190833,3191682,gene,-1,849,lytG
6939,CDS,3190833,3191682,CDS,-1,849,yubD
6940,gene,3191842,3193378,gene,-1,1536,yubD
6941,CDS,3191842,3193378,CDS,-1,1536,cdoA
6942,gene,3193862,3194348,gene,1,486,cdoA
6943,CDS,3193862,3194348,CDS,1,486,trnSL-Ala1
6944,gene,3194454,3194527,gene,-1,73,trnSL-Ala1
6945,tRNA,3194454,3194527,else,-1,73,uppP
6947,CDS,3194634,3195465,CDS,-1,831,yubA
6946,gene,3194634,3195465,gene,-1,831,uppP
6948,gene,3195557,3196724,gene,-1,1167,yubA
6949,CDS,3195557,3196724,CDS,-1,1167,iolU
6950,gene,3196905,3197892,gene,1,987,iolU
6951,CDS,3196905,3197892,CDS,1,987,rhaA
6952,gene,3197932,3199207,gene,-1,1275,rhaA
6953,CDS,3197932,3199207,CDS,-1,1275,rhaM
6954,gene,3199232,3199547,gene,-1,315,rhaM
6955,CDS,3199232,3199547,CDS,-1,315,rhaB
6956,gene,3199564,3201022,gene,-1,1458,rhaB
6957,CDS,3199564,3201022,CDS,-1,1458,rhaR
6958,gene,3201026,3201803,gene,-1,777,rhaR
6959,CDS,3201026,3201803,CDS,-1,777,rhaE
6960,gene,3201859,3203929,gene,-1,2070,rhaE
6961,CDS,3201859,3203929,CDS,-1,2070,tlpB
6963,CDS,3204066,3206055,CDS,-1,1989,mcpA
6962,gene,3204066,3206055,gene,-1,1989,tlpB
6964,gene,3206168,3208154,gene,-1,1986,mcpA
6965,CDS,3206168,3208154,CDS,-1,1986,tlpA
6966,gene,3208279,3210268,gene,-1,1989,tlpA
6967,CDS,3208279,3210268,CDS,-1,1989,mcpB
6968,gene,3210444,3212433,gene,-1,1989,mcpB
6969,CDS,3210444,3212433,CDS,-1,1989,tgl
6971,CDS,3212590,3213328,CDS,1,738,yuzH
6970,gene,3212590,3213328,gene,1,738,tgl
6972,gene,3213341,3213596,gene,-1,255,yuzH
6973,CDS,3213341,3213596,CDS,-1,255,yugU
6974,gene,3213853,3214252,gene,-1,399,yugU
6975,CDS,3213853,3214252,CDS,-1,399,BSU_31289
6976,gene,3214211,3214346,gene,-1,135,BSU_31289
6977,CDS,3214211,3214346,CDS,-1,135,yugT
6978,gene,3214371,3216036,gene,-1,1665,yugT
6979,CDS,3214371,3216036,CDS,-1,1665,yugS
6981,CDS,3216162,3217452,CDS,-1,1290,yugP
6980,gene,3216162,3217452,gene,-1,1290,yugS
6982,gene,3217495,3218173,gene,-1,678,yugP
6983,CDS,3217495,3218173,CDS,-1,678,yuzI
6984,gene,3218214,3218478,gene,-1,264,yuzI
6985,CDS,3218214,3218478,CDS,-1,264,mstX
6986,gene,3218524,3218857,gene,1,333,mstX
6987,CDS,3218524,3218857,CDS,1,333,kbfO
6989,CDS,3218853,3219840,CDS,1,987,yugN
6988,gene,3218853,3219840,gene,1,987,kbfO
6990,gene,3219836,3220241,gene,-1,405,yugN
6991,CDS,3219836,3220241,CDS,-1,405,yugM
6992,gene,3220300,3220672,gene,-1,372,yugM
6993,CDS,3220300,3220672,CDS,-1,372,pgi
6994,gene,3220730,3222083,gene,-1,1353,pgi
6995,CDS,3220730,3222083,CDS,-1,1353,bdhK
6996,gene,3222194,3223367,gene,-1,1173,bdhK
6997,CDS,3222194,3223367,CDS,-1,1173,bdhJ
6999,CDS,3223470,3224634,CDS,-1,1164,yuzA
6998,gene,3223470,3224634,gene,-1,1164,bdhJ
7000,gene,3224863,3225100,gene,1,237,yuzA
7001,CDS,3224863,3225100,CDS,1,237,yugI
7002,gene,3225177,3225570,gene,-1,393,yugI
7003,CDS,3225177,3225570,CDS,-1,393,yugH
7004,gene,3225771,3226932,gene,-1,1161,yugH
7005,CDS,3225771,3226932,CDS,-1,1161,yugG
7006,gene,3226932,3227433,gene,-1,501,yugG
7007,CDS,3226932,3227433,CDS,-1,501,yugF
7008,gene,3227580,3228402,gene,1,822,yugF
7009,CDS,3227580,3228402,CDS,1,822,yugE
7010,gene,3228430,3228691,gene,-1,261,yugE
7011,CDS,3228430,3228691,CDS,-1,261,patB
7012,gene,3228777,3229941,gene,1,1164,patB
7013,CDS,3228777,3229941,CDS,1,1164,kinB
7014,gene,3230066,3231353,gene,1,1287,kinB
7015,CDS,3230066,3231353,CDS,1,1287,kapB
7017,CDS,3231398,3231785,CDS,1,387,kapD
7016,gene,3231398,3231785,gene,1,387,kapB
7018,gene,3231811,3232429,gene,-1,618,kapD
7019,CDS,3231811,3232429,CDS,-1,618,yuxJ
7020,gene,3232639,3233818,gene,1,1179,yuxJ
7021,CDS,3232639,3233818,CDS,1,1179,pbpD
7022,gene,3233910,3235785,gene,1,1875,pbpD
7023,CDS,3233910,3235785,CDS,1,1875,yuxK
7025,CDS,3235805,3236219,CDS,1,414,yufK
7024,gene,3235805,3236219,gene,1,414,yuxK
7026,gene,3236421,3236979,gene,-1,558,yufK
7027,CDS,3236421,3236979,CDS,-1,558,maeL
7028,gene,3237156,3238758,gene,1,1602,maeL
7029,CDS,3237156,3238758,CDS,1,1602,maeM
7030,gene,3238750,3239458,gene,1,708,maeM
7031,CDS,3238750,3239458,CDS,1,708,nupN
7033,CDS,3239929,3241009,CDS,1,1080,nupO
7032,gene,3239929,3241009,gene,1,1080,nupN
7035,CDS,3241084,3242617,CDS,1,1533,nupP
7034,gene,3241084,3242617,gene,1,1533,nupO
7036,gene,3242609,3243656,gene,1,1047,nupP
7037,CDS,3242609,3243656,CDS,1,1047,nupQ
7038,gene,3243656,3244616,gene,1,960,nupQ
7039,CDS,3243656,3244616,CDS,1,960,maeN
7040,gene,3244769,3246116,gene,1,1347,maeN
7041,CDS,3244769,3246116,CDS,1,1347,yufS
7042,gene,3246151,3246367,gene,-1,216,yufS
7043,CDS,3246151,3246367,CDS,-1,216,mrpA
7045,CDS,3246597,3249003,CDS,1,2406,mrpB
7044,gene,3246597,3249003,gene,1,2406,mrpA
7046,gene,3248995,3249427,gene,1,432,mrpB
7047,CDS,3248995,3249427,CDS,1,432,mrpC
7048,gene,3249426,3249768,gene,1,342,mrpC
7049,CDS,3249426,3249768,CDS,1,342,mrpD
7050,gene,3249760,3251242,gene,1,1482,mrpD
7051,CDS,3249760,3251242,CDS,1,1482,mrpE
7053,CDS,3251247,3251724,CDS,1,477,mrpF
7052,gene,3251247,3251724,gene,1,477,mrpE
7054,gene,3251723,3252008,gene,1,285,mrpF
7055,CDS,3251723,3252008,CDS,1,285,mrpG
7056,gene,3251991,3252366,gene,1,375,mrpG
7057,CDS,3251991,3252366,CDS,1,375,yuxO
7058,gene,3252404,3252785,gene,-1,381,yuxO
7059,CDS,3252404,3252785,CDS,-1,381,comA
7060,gene,3252803,3253448,gene,-1,645,comA
7061,CDS,3252803,3253448,CDS,-1,645,comP
7062,gene,3253528,3255838,gene,-1,2310,comP
7063,CDS,3253528,3255838,CDS,-1,2310,comX
7064,gene,3255852,3256020,gene,-1,168,comX
7065,CDS,3255852,3256020,CDS,-1,168,comQ
7066,gene,3256007,3256907,gene,-1,900,comQ
7067,CDS,3256007,3256907,CDS,-1,900,degQ
7069,CDS,3257091,3257232,CDS,-1,141,BSU_31725
7068,gene,3257091,3257232,gene,-1,141,degQ
7070,gene,3257453,3257579,gene,1,126,BSU_31725
7071,CDS,3257453,3257579,CDS,1,126,cotIC
7072,gene,3257692,3258061,gene,1,369,cotIC
7073,CDS,3257692,3258061,CDS,1,369,pdeH
7074,gene,3258036,3259266,gene,-1,1230,pdeH
7075,CDS,3258036,3259266,CDS,-1,1230,pncB
7077,CDS,3259402,3260875,CDS,-1,1473,pncA
7076,gene,3259402,3260875,gene,-1,1473,pncB
7078,gene,3260890,3261442,gene,-1,552,pncA
7079,CDS,3260890,3261442,CDS,-1,552,yueI
7080,gene,3261538,3261937,gene,-1,399,yueI
7081,CDS,3261538,3261937,CDS,-1,399,yueH
7082,gene,3262008,3262257,gene,-1,249,yueH
7083,CDS,3262008,3262257,CDS,-1,249,yueG
7084,gene,3262329,3262551,gene,-1,222,yueG
7085,CDS,3262329,3262551,CDS,-1,222,yueF
7086,gene,3262610,3263720,gene,-1,1110,yueF
7087,CDS,3262610,3263720,CDS,-1,1110,yuzE
7089,CDS,3263834,3264224,CDS,1,390,yuzF
7088,gene,3263834,3264224,gene,1,390,yuzE
7090,gene,3264264,3264501,gene,-1,237,yuzF
7091,CDS,3264264,3264501,CDS,-1,237,yueE
7092,gene,3264677,3265208,gene,-1,531,yueE
7093,CDS,3264677,3265208,CDS,-1,531,bznD
7094,gene,3265405,3266137,gene,-1,732,bznD
7095,CDS,3265405,3266137,CDS,-1,732,yueC
7096,gene,3266199,3266655,gene,-1,456,yueC
7097,CDS,3266199,3266655,CDS,-1,456,yueB
7098,gene,3266686,3269917,gene,-1,3231,yueB
7099,CDS,3266686,3269917,CDS,-1,3231,yukAB
7100,gene,3269913,3274401,gene,-1,4488,yukAB
7101,CDS,3269913,3274401,CDS,-1,4488,yukC
7102,gene,3274461,3275817,gene,-1,1356,yukC
7103,CDS,3274461,3275817,CDS,-1,1356,yukD
7105,CDS,3275831,3276071,CDS,-1,240,yukE
7104,gene,3275831,3276071,gene,-1,240,yukD
7106,gene,3276140,3276434,gene,-1,294,yukE
7107,CDS,3276140,3276434,CDS,-1,294,adeR
7108,gene,3276954,3278223,gene,1,1269,adeR
7109,CDS,3276954,3278223,CDS,1,1269,ald
7110,gene,3278324,3279461,gene,1,1137,ald
7111,CDS,3278324,3279461,CDS,1,1137,yukJ
7113,CDS,3279572,3280250,CDS,1,678,mbtH
7112,gene,3279572,3280250,gene,1,678,yukJ
7114,gene,3280293,3280503,gene,-1,210,mbtH
7115,CDS,3280293,3280503,CDS,-1,210,dhbF
7116,gene,3280518,3287655,gene,-1,7137,dhbF
7117,CDS,3280518,3287655,CDS,-1,7137,dhbB
7118,gene,3287674,3288613,gene,-1,939,dhbB
7119,CDS,3287674,3288613,CDS,-1,939,dhbE
7120,gene,3288640,3290260,gene,-1,1620,dhbE
7121,CDS,3288640,3290260,CDS,-1,1620,dhbC
7123,CDS,3290288,3291485,CDS,-1,1197,dhbA
7122,gene,3290288,3291485,gene,-1,1197,dhbC
7124,gene,3291510,3292296,gene,-1,786,dhbA
7125,CDS,3291510,3292296,CDS,-1,786,besA
7126,gene,3292489,3293359,gene,-1,870,besA
7127,CDS,3292489,3293359,CDS,-1,870,yuiH
7128,gene,3293572,3294169,gene,-1,597,yuiH
7129,CDS,3293572,3294169,CDS,-1,597,bioYB
7131,CDS,3294269,3294872,CDS,1,603,hisP
7130,gene,3294269,3294872,gene,1,603,bioYB
7132,gene,3294941,3296270,gene,-1,1329,hisP
7133,CDS,3294941,3296270,CDS,-1,1329,pepA
7134,gene,3296416,3297919,gene,-1,1503,pepA
7135,CDS,3296416,3297919,CDS,-1,1503,yuiD
7136,gene,3298076,3298553,gene,1,477,yuiD
7137,CDS,3298076,3298553,CDS,1,477,spsC
7138,gene,3298583,3299240,gene,-1,657,spsC
7139,CDS,3298583,3299240,CDS,-1,657,yuiB
7141,CDS,3299343,3299664,CDS,-1,321,yuiA
7140,gene,3299343,3299664,gene,-1,321,yuiB
7142,gene,3299717,3299861,gene,-1,144,yuiA
7143,CDS,3299717,3299861,CDS,-1,144,yumB
7144,gene,3300033,3301254,gene,-1,1221,yumB
7145,CDS,3300033,3301254,CDS,-1,1221,trxBB
7146,gene,3301585,3302584,gene,1,999,trxBB
7147,CDS,3301585,3302584,CDS,1,999,yuzG
7148,gene,3302622,3302763,gene,-1,141,yuzG
7149,CDS,3302622,3302763,CDS,-1,141,guaC
7150,gene,3303041,3304022,gene,1,981,guaC
7151,CDS,3303041,3304022,CDS,1,981,paiB
7152,gene,3304095,3304719,gene,-1,624,paiB
7153,CDS,3304095,3304719,CDS,-1,624,paiA
7154,gene,3304742,3305261,gene,-1,519,paiA
7155,CDS,3304742,3305261,CDS,-1,519,sufA
7156,gene,3305598,3305961,gene,-1,363,sufA
7157,CDS,3305598,3305961,CDS,-1,363,dapF
7159,CDS,3306039,3306894,CDS,-1,855,yutK
7158,gene,3306039,3306894,gene,-1,855,dapF
7160,gene,3307016,3308231,gene,-1,1215,yutK
7161,CDS,3307016,3308231,CDS,-1,1215,yuzB
7162,gene,3308367,3308604,gene,-1,237,yuzB
7163,CDS,3308367,3308604,CDS,-1,237,yutJ
7164,gene,3308866,3309934,gene,1,1068,yutJ
7165,CDS,3308866,3309934,CDS,1,1068,yuzD
7167,CDS,3309959,3310286,CDS,-1,327,yutI
7166,gene,3309959,3310286,gene,-1,327,yuzD
7168,gene,3310385,3310721,gene,1,336,yutI
7169,CDS,3310385,3310721,CDS,1,336,yuxL
7170,gene,3310762,3312736,gene,-1,1974,yuxL
7171,CDS,3310762,3312736,CDS,-1,1974,thrB
7172,gene,3312843,3313773,gene,-1,930,thrB
7173,CDS,3312843,3313773,CDS,-1,930,thrC
7175,CDS,3313769,3314828,CDS,-1,1059,hom
7174,gene,3313769,3314828,gene,-1,1059,thrC
7177,CDS,3314827,3316129,CDS,-1,1302,cotNH
7176,gene,3314827,3316129,gene,-1,1302,hom
7178,gene,3316329,3317349,gene,-1,1020,cotNH
7179,CDS,3316329,3317349,CDS,-1,1020,yutG
7180,gene,3317501,3318002,gene,1,501,yutG
7181,CDS,3317501,3318002,CDS,1,501,nucF
7182,gene,3318028,3318799,gene,-1,771,nucF
7183,CDS,3318028,3318799,CDS,-1,771,yutE
7184,gene,3318827,3319262,gene,-1,435,yutE
7185,CDS,3318827,3319262,CDS,-1,435,yutD
7187,CDS,3319285,3319561,CDS,-1,276,yutC
7186,gene,3319285,3319561,gene,-1,276,yutD
7188,gene,3319675,3320308,gene,1,633,yutC
7189,CDS,3319675,3320308,CDS,1,633,lipA
7190,gene,3320323,3321220,gene,-1,897,lipA
7191,CDS,3320323,3321220,CDS,-1,897,lytH
7192,gene,3321454,3322435,gene,1,981,lytH
7193,CDS,3321454,3322435,CDS,1,981,fisB
7195,CDS,3322462,3323227,CDS,-1,765,yunC
7194,gene,3322462,3323227,gene,-1,765,fisB
7196,gene,3323299,3323605,gene,-1,306,yunC
7197,CDS,3323299,3323605,CDS,-1,306,yunD
7198,gene,3323669,3325058,gene,-1,1389,yunD
7199,CDS,3323669,3325058,CDS,-1,1389,yunE
7200,gene,3325077,3325899,gene,-1,822,yunE
7201,CDS,3325077,3325899,CDS,-1,822,yunF
7202,gene,3325916,3326765,gene,-1,849,yunF
7203,CDS,3325916,3326765,CDS,-1,849,yunG
7204,gene,3326802,3327150,gene,-1,348,yunG
7205,CDS,3326802,3327150,CDS,-1,348,pucH
7206,gene,3327246,3328587,gene,-1,1341,pucH
7207,CDS,3327246,3328587,CDS,-1,1341,pucR
7208,gene,3328761,3330357,gene,1,1596,pucR
7209,CDS,3328761,3330357,CDS,1,1596,pucJ
7211,CDS,3330501,3331851,CDS,1,1350,pucK
7210,gene,3330501,3331851,gene,1,1350,pucJ
7212,gene,3331856,3333149,gene,1,1293,pucK
7213,CDS,3331856,3333149,CDS,1,1293,pucL
7214,gene,3333161,3334646,gene,1,1485,pucL
7215,CDS,3333161,3334646,CDS,1,1485,pucM
7216,gene,3334645,3334990,gene,1,345,pucM
7217,CDS,3334645,3334990,CDS,1,345,yuzJ
7219,gene,3335413,3335545,gene,-1,132,auzJ
7218,gene,3335413,3335545,gene,1,132,auzJ
7220,ncRNA,3335413,3335545,else,-1,132,yuzJ
7221,CDS,3335413,3335545,CDS,1,132,pucE
7222,gene,3335750,3336272,gene,-1,522,pucE
7223,CDS,3335750,3336272,CDS,-1,522,pucD
7224,gene,3336262,3338500,gene,-1,2238,pucD
7225,CDS,3336262,3338500,CDS,-1,2238,pucC
7226,gene,3338500,3339334,gene,-1,834,pucC
7227,CDS,3338500,3339334,CDS,-1,834,pucB
7229,CDS,3339330,3339948,CDS,-1,618,pucA
7228,gene,3339330,3339948,gene,-1,618,pucB
7231,CDS,3339944,3340937,CDS,-1,993,pucG
7230,gene,3339944,3340937,gene,-1,993,pucA
7232,gene,3341165,3342416,gene,-1,1251,pucG
7233,CDS,3341165,3342416,CDS,-1,1251,pucF
7234,gene,3342432,3343671,gene,-1,1239,pucF
7235,CDS,3342432,3343671,CDS,-1,1239,BSU_32539
7236,gene,3343893,3344031,gene,1,138,BSU_32539
7237,CDS,3343893,3344031,CDS,1,138,bsnA
7238,gene,3344112,3344979,gene,1,867,bsnA
7239,CDS,3344112,3344979,CDS,1,867,frlP
7240,gene,3345012,3346116,gene,-1,1104,frlP
7241,CDS,3345012,3346116,CDS,-1,1104,frlR
7242,gene,3346297,3347026,gene,1,729,frlR
7243,CDS,3346297,3347026,CDS,1,729,frlD
7244,gene,3347050,3347905,gene,-1,855,frlD
7245,CDS,3347050,3347905,CDS,-1,855,frlM
7246,gene,3347918,3348821,gene,-1,903,frlM
7247,CDS,3347918,3348821,CDS,-1,903,frlN
7249,CDS,3348824,3349703,CDS,-1,879,frlO
7248,gene,3348824,3349703,gene,-1,879,frlN
7250,gene,3349760,3351029,gene,-1,1269,frlO
7251,CDS,3349760,3351029,CDS,-1,1269,frlB
7252,gene,3351109,3352096,gene,-1,987,frlB
7253,CDS,3351109,3352096,CDS,-1,987,yurQ
7254,gene,3352311,3352686,gene,-1,375,yurQ
7255,CDS,3352311,3352686,CDS,-1,375,dadA
7257,CDS,3352788,3353907,CDS,-1,1119,sspG
7256,gene,3352788,3353907,gene,-1,1119,dadA
7258,gene,3354065,3354212,gene,1,147,sspG
7259,CDS,3354065,3354212,CDS,1,147,yurS
7260,gene,3354211,3354487,gene,1,276,yurS
7261,CDS,3354211,3354487,CDS,1,276,glxB
7262,gene,3354550,3354934,gene,-1,384,glxB
7263,CDS,3354550,3354934,CDS,-1,384,yuzN
7265,CDS,3355044,3355323,CDS,-1,279,sufB
7264,gene,3355044,3355323,gene,-1,279,yuzN
7267,CDS,3355592,3356990,CDS,-1,1398,sufU
7266,gene,3355592,3356990,gene,-1,1398,sufB
7268,gene,3357010,3357454,gene,-1,444,sufU
7269,CDS,3357010,3357454,CDS,-1,444,sufS
7270,gene,3357443,3358664,gene,-1,1221,sufS
7271,CDS,3357443,3358664,CDS,-1,1221,sufD
7272,gene,3358663,3359977,gene,-1,1314,sufD
7273,CDS,3358663,3359977,CDS,-1,1314,sufC
7274,gene,3359994,3360780,gene,-1,786,sufC
7275,CDS,3359994,3360780,CDS,-1,786,bsrI
7277,misc_RNA,3360936,3361184,else,-1,248,yuzK
7276,gene,3360936,3361184,gene,-1,248,bsrI
7278,gene,3360973,3361111,gene,-1,138,yuzK
7279,CDS,3360973,3361111,CDS,-1,138,yurZ
7280,gene,3361304,3361682,gene,-1,378,yurZ
7281,CDS,3361304,3361682,CDS,-1,378,metQ
7282,gene,3361766,3362591,gene,-1,825,metQ
7283,CDS,3361766,3362591,CDS,-1,825,metP
7285,CDS,3362604,3363273,CDS,-1,669,metN
7284,gene,3362604,3363273,gene,-1,669,metP
7286,gene,3363265,3364291,gene,-1,1026,metN
7287,CDS,3363265,3364291,CDS,-1,1026,mswH
7288,gene,3364396,3364503,gene,-1,107,mswH
7289,misc_RNA,3364396,3364503,else,-1,107,yusD
7290,gene,3364617,3364962,gene,-1,345,yusD
7291,CDS,3364617,3364962,CDS,-1,345,yusE
7292,gene,3365068,3365389,gene,-1,321,yusE
7293,CDS,3365068,3365389,CDS,-1,321,yusF
7294,gene,3365390,3365831,gene,-1,441,yusF
7295,CDS,3365390,3365831,CDS,-1,441,yusG
7296,gene,3365830,3366067,gene,-1,237,yusG
7297,CDS,3365830,3366067,CDS,-1,237,gcvH
7298,gene,3366122,3366506,gene,-1,384,gcvH
7299,CDS,3366122,3366506,CDS,-1,384,yusI
7301,CDS,3366572,3366929,CDS,-1,357,fadE
7300,gene,3366572,3366929,gene,-1,357,yusI
7302,gene,3367039,3368824,gene,-1,1785,fadE
7303,CDS,3367039,3368824,CDS,-1,1785,fadA
7304,gene,3368838,3370014,gene,-1,1176,fadA
7305,CDS,3368838,3370014,CDS,-1,1176,fadN
7306,gene,3370024,3372394,gene,-1,2370,fadN
7307,CDS,3370024,3372394,CDS,-1,2370,yuzL
7308,gene,3372568,3372715,gene,1,147,yuzL
7309,CDS,3372568,3372715,CDS,1,147,putM
7310,gene,3372739,3373648,gene,-1,909,putM
7311,CDS,3372739,3373648,CDS,-1,909,yuzM
7312,gene,3373742,3373988,gene,1,246,yuzM
7313,CDS,3373742,3373988,CDS,1,246,yusN
7314,gene,3374000,3374333,gene,1,333,yusN
7315,CDS,3374000,3374333,CDS,1,333,mdtR
7317,CDS,3374491,3374959,CDS,1,468,mdtP
7316,gene,3374491,3374959,gene,1,468,mdtR
7318,gene,3374955,3376581,gene,1,1626,mdtP
7319,CDS,3374955,3376581,CDS,1,1626,yusQ
7320,gene,3376616,3377000,gene,-1,384,yusQ
7321,CDS,3376616,3377000,CDS,-1,384,yusR
7322,gene,3377018,3377408,gene,-1,390,yusR
7323,CDS,3377018,3377408,CDS,-1,390,yusS
7325,CDS,3377429,3377759,CDS,-1,330,yusT
7324,gene,3377429,3377759,gene,-1,330,yusS
7326,gene,3377892,3378780,gene,1,888,yusT
7327,CDS,3377892,3378780,CDS,1,888,yusU
7328,gene,3378799,3379087,gene,-1,288,yusU
7329,CDS,3378799,3379087,CDS,-1,288,feuV
7330,gene,3379111,3379939,gene,-1,828,feuV
7331,CDS,3379111,3379939,CDS,-1,828,cotNW
7332,gene,3380156,3380594,gene,-1,438,cotNW
7333,CDS,3380156,3380594,CDS,-1,438,yusYc
7335,misc_feature,3380703,3382212,else,-1,1509,yusYn
7334,gene,3380703,3382212,gene,-1,1509,yusYc
7336,gene,3382208,3382499,gene,-1,291,yusYn
7337,misc_feature,3382208,3382499,else,-1,291,yusZ
7338,gene,3382632,3383475,gene,1,843,yusZ
7339,CDS,3382632,3383475,CDS,1,843,mrgA
7340,gene,3383564,3384026,gene,1,462,mrgA
7341,CDS,3383564,3384026,CDS,1,462,htrB
7343,CDS,3384069,3385446,CDS,-1,1377,cssR
7342,gene,3384069,3385446,gene,-1,1377,htrB
7344,gene,3385723,3386401,gene,1,678,cssR
7345,CDS,3385723,3386401,CDS,1,678,cssS
7346,gene,3386397,3387753,gene,1,1356,cssS
7347,CDS,3386397,3387753,CDS,1,1356,spxO
7348,gene,3387780,3387945,gene,-1,165,spxO
7349,CDS,3387780,3387945,CDS,-1,165,yuxN
7350,gene,3388112,3388988,gene,1,876,yuxN
7351,CDS,3388112,3388988,CDS,1,876,fumC
7353,CDS,3389023,3390412,CDS,-1,1389,yvzF
7352,gene,3389023,3390412,gene,-1,1389,fumC
7354,gene,3390478,3390664,gene,-1,186,yvzF
7355,CDS,3390478,3390664,CDS,-1,186,gerAA
7356,gene,3390781,3392230,gene,1,1449,gerAA
7357,CDS,3390781,3392230,CDS,1,1449,gerAB
7358,gene,3392198,3393296,gene,1,1098,gerAB
7359,CDS,3392198,3393296,CDS,1,1098,gerAC
7360,gene,3393292,3394414,gene,1,1122,gerAC
7361,CDS,3393292,3394414,CDS,1,1122,liaR
7362,gene,3394421,3395057,gene,-1,636,liaR
7363,CDS,3394421,3395057,CDS,-1,636,liaS
7364,gene,3395034,3396117,gene,-1,1083,liaS
7365,CDS,3395034,3396117,CDS,-1,1083,liaF
7366,gene,3396113,3396839,gene,-1,726,liaF
7367,CDS,3396113,3396839,CDS,-1,726,liaG
7368,gene,3396872,3397745,gene,-1,873,liaG
7369,CDS,3396872,3397745,CDS,-1,873,liaH
7371,CDS,3397845,3398523,CDS,-1,678,liaI
7370,gene,3397845,3398523,gene,-1,678,liaH
7373,CDS,3398549,3398930,CDS,-1,381,yvqJ
7372,gene,3398549,3398930,gene,-1,381,liaI
7374,gene,3399091,3400360,gene,-1,1269,yvqJ
7375,CDS,3399091,3400360,CDS,-1,1269,yvqK
7376,gene,3400536,3401118,gene,-1,582,yvqK
7377,CDS,3400536,3401118,CDS,-1,582,yvrA
7378,gene,3401140,3402469,gene,-1,1329,yvrA
7379,CDS,3401140,3402469,CDS,-1,1329,yvrB
7380,gene,3402468,3403530,gene,-1,1062,yvrB
7381,CDS,3402468,3403530,CDS,-1,1062,yvrC
7382,gene,3403492,3404437,gene,-1,945,yvrC
7383,CDS,3403492,3404437,CDS,-1,945,srbL
7384,gene,3404545,3404676,gene,-1,131,srbL
7385,misc_RNA,3404545,3404676,else,-1,131,yvrD
7386,gene,3404834,3405626,gene,1,792,yvrD
7387,CDS,3404834,3405626,CDS,1,792,yvrE
7389,CDS,3405663,3406542,CDS,-1,879,yvrG
7388,gene,3405663,3406542,gene,-1,879,yvrE
7390,gene,3406613,3408356,gene,-1,1743,yvrG
7391,CDS,3406613,3408356,CDS,-1,1743,yvrH
7392,gene,3408352,3409066,gene,-1,714,yvrH
7393,CDS,3408352,3409066,CDS,-1,714,rsoA
7394,gene,3409218,3409458,gene,-1,240,rsoA
7395,CDS,3409218,3409458,CDS,-1,240,sigO
7397,CDS,3409461,3409992,CDS,-1,531,yvrJ
7396,gene,3409461,3409992,gene,-1,531,sigO
7398,gene,3410006,3410345,gene,1,339,yvrJ
7399,CDS,3410006,3410345,CDS,1,339,oxdC
7400,gene,3410465,3411623,gene,1,1158,oxdC
7401,CDS,3410465,3411623,CDS,1,1158,rsiO
7402,gene,3411683,3412094,gene,1,411,rsiO
7403,CDS,3411683,3412094,CDS,1,411,yvrN
7404,gene,3412127,3413357,gene,-1,1230,yvrN
7405,CDS,3412127,3413357,CDS,-1,1230,yvrO
7407,CDS,3413349,3414039,CDS,-1,690,yvrP
7406,gene,3413349,3414039,gene,-1,690,yvrO
7408,gene,3414022,3415216,gene,-1,1194,yvrP
7409,CDS,3414022,3415216,CDS,-1,1194,fhuC
7410,gene,3415386,3416196,gene,-1,810,fhuC
7411,CDS,3415386,3416196,CDS,-1,810,fhuG
7412,gene,3416211,3417222,gene,-1,1011,fhuG
7413,CDS,3416211,3417222,CDS,-1,1011,fhuB
7415,CDS,3417221,3418376,CDS,-1,1155,fhuD
7414,gene,3417221,3418376,gene,-1,1155,fhuB
7416,gene,3418473,3419421,gene,1,948,fhuD
7417,CDS,3418473,3419421,CDS,1,948,lysP
7418,gene,3419655,3421065,gene,-1,1410,lysP
7419,CDS,3419655,3421065,CDS,-1,1410,kswB
7420,gene,3421168,3421348,gene,-1,180,kswB
7421,misc_RNA,3421168,3421348,else,-1,180,sspJ
7422,gene,3421464,3421605,gene,-1,141,sspJ
7423,CDS,3421464,3421605,CDS,-1,141,yvsG
7425,CDS,3421771,3422254,CDS,1,483,ltaSP
7424,gene,3421771,3422254,gene,1,483,yvsG
7426,gene,3422353,3424207,gene,1,1854,ltaSP
7427,CDS,3422353,3424207,CDS,1,1854,yvgK
7428,gene,3424234,3425161,gene,-1,927,yvgK
7429,CDS,3424234,3425161,CDS,-1,927,modA
7430,gene,3425271,3426054,gene,1,783,modA
7431,CDS,3425271,3426054,CDS,1,783,modB
7432,gene,3426025,3426718,gene,1,693,modB
7433,CDS,3426025,3426718,CDS,1,693,pgoN
7434,gene,3426748,3427579,gene,-1,831,pgoN
7435,CDS,3426748,3427579,CDS,-1,831,yvgO
7436,gene,3427801,3428287,gene,1,486,yvgO
7437,CDS,3427801,3428287,CDS,1,486,nhaK
7438,gene,3428330,3430343,gene,-1,2013,nhaK
7439,CDS,3428330,3430343,CDS,-1,2013,cysI
7440,gene,3430597,3432313,gene,-1,1716,cysI
7441,CDS,3430597,3432313,CDS,-1,1716,cysJ
7443,CDS,3432338,3434156,CDS,-1,1818,helD
7442,gene,3432338,3434156,gene,-1,1818,cysJ
7444,gene,3434326,3436651,gene,-1,2325,helD
7445,CDS,3434326,3436651,CDS,-1,2325,yvgT
7446,gene,3436848,3437457,gene,-1,609,yvgT
7447,CDS,3436848,3437457,CDS,-1,609,bdbC
7448,gene,3437643,3438060,gene,-1,417,bdbC
7449,CDS,3437643,3438060,CDS,-1,417,bdbD
7451,CDS,3438064,3438733,CDS,-1,669,cadA
7450,gene,3438064,3438733,gene,-1,669,bdbD
7452,gene,3438852,3440961,gene,-1,2109,cadA
7453,CDS,3438852,3440961,CDS,-1,2109,copA
7454,gene,3441120,3443529,gene,-1,2409,copA
7455,CDS,3441120,3443529,CDS,-1,2409,copZ
7456,gene,3443612,3443822,gene,-1,210,copZ
7457,CDS,3443612,3443822,CDS,-1,210,csoR
7459,CDS,3443895,3444201,CDS,-1,306,iolW
7458,gene,3443895,3444201,gene,-1,306,csoR
7461,CDS,3444328,3445405,CDS,1,1077,azoRB
7460,gene,3444328,3445405,gene,1,1077,iolW
7462,gene,3445441,3446077,gene,-1,636,azoRB
7463,CDS,3445441,3446077,CDS,-1,636,yvaC
7464,gene,3446236,3448132,gene,-1,1896,yvaC
7465,CDS,3446236,3448132,CDS,-1,1896,yvaD
7466,gene,3448294,3448696,gene,-1,402,yvaD
7467,CDS,3448294,3448696,CDS,-1,402,yvaE
7468,gene,3448692,3449052,gene,-1,360,yvaE
7469,CDS,3448692,3449052,CDS,-1,360,yvaF
7471,CDS,3449048,3449621,CDS,-1,573,yvaG
7470,gene,3449048,3449621,gene,-1,573,yvaF
7472,gene,3449731,3450526,gene,-1,795,yvaG
7473,CDS,3449731,3450526,CDS,-1,795,ssrA
7474,gene,3450711,3451071,gene,-1,360,ssrA
7475,misc_RNA,3450711,3451071,else,-1,360,smpB
7476,gene,3451247,3451718,gene,-1,471,smpB
7477,CDS,3451247,3451718,CDS,-1,471,rnr
7479,CDS,3451862,3454202,CDS,-1,2340,estA
7478,gene,3451862,3454202,gene,-1,2340,rnr
7480,gene,3454220,3454961,gene,-1,741,estA
7481,CDS,3454220,3454961,CDS,-1,741,secG
7482,gene,3455092,3455323,gene,-1,231,secG
7483,CDS,3455092,3455323,CDS,-1,231,yvaM
7484,gene,3455471,3456242,gene,1,771,yvaM
7485,CDS,3455471,3456242,CDS,1,771,yvzC
7486,gene,3456281,3456515,gene,-1,234,yvzC
7487,CDS,3456281,3456515,CDS,-1,234,rghRA
7488,gene,3456666,3457074,gene,1,408,rghRA
7489,CDS,3456666,3457074,CDS,1,408,rghRB
7490,gene,3457103,3457523,gene,1,420,rghRB
7491,CDS,3457103,3457523,CDS,1,420,catR
7492,gene,3457614,3457941,gene,1,327,catR
7493,CDS,3457614,3457941,CDS,1,327,yvaQ
7495,CDS,3458065,3459766,CDS,1,1701,opuBD
7494,gene,3458065,3459766,gene,1,1701,yvaQ
7496,gene,3459805,3460486,gene,-1,681,opuBD
7497,CDS,3459805,3460486,CDS,-1,681,opuBC
7498,gene,3460502,3461423,gene,-1,921,opuBC
7499,CDS,3460502,3461423,CDS,-1,921,opuBB
7500,gene,3461434,3462088,gene,-1,654,opuBB
7501,CDS,3461434,3462088,CDS,-1,654,opuBA
7503,CDS,3462104,3463250,CDS,-1,1146,yvaV
7502,gene,3462104,3463250,gene,-1,1146,opuBA
7504,gene,3463533,3464067,gene,1,534,yvaV
7505,CDS,3463533,3464067,CDS,1,534,sdpA
7506,gene,3464288,3464765,gene,1,477,sdpA
7507,CDS,3464288,3464765,CDS,1,477,sdpB
7508,gene,3464761,3465733,gene,1,972,sdpB
7509,CDS,3464761,3465733,CDS,1,972,spbC
7510,gene,3465775,3466387,gene,1,612,spbC
7511,CDS,3465775,3466387,CDS,1,612,sdpI
7512,gene,3466433,3467057,gene,-1,624,sdpI
7513,CDS,3466433,3467057,CDS,-1,624,sdpR
7515,CDS,3467053,3467326,CDS,-1,273,opuCD
7514,gene,3467053,3467326,gene,-1,273,sdpR
7516,gene,3467545,3468235,gene,-1,690,opuCD
7517,CDS,3467545,3468235,CDS,-1,690,opuCC
7518,gene,3468252,3469164,gene,-1,912,opuCC
7519,CDS,3468252,3469164,CDS,-1,912,opuCB
7520,gene,3469183,3469837,gene,-1,654,opuCB
7521,CDS,3469183,3469837,CDS,-1,654,opuCA
7522,gene,3469859,3471002,gene,-1,1143,opuCA
7523,CDS,3469859,3471002,CDS,-1,1143,opcR
7524,gene,3471265,3471823,gene,1,558,opcR
7525,CDS,3471265,3471823,CDS,1,558,yvbG
7526,gene,3471840,3472476,gene,-1,636,yvbG
7527,CDS,3471840,3472476,CDS,-1,636,yvbH
7528,gene,3472625,3473240,gene,1,615,yvbH
7529,CDS,3472625,3473240,CDS,1,615,yvbI
7531,CDS,3473371,3474070,CDS,1,699,yvbJ
7530,gene,3473371,3474070,gene,1,699,yvbI
7532,gene,3474105,3475923,gene,-1,1818,yvbJ
7533,CDS,3474105,3475923,CDS,-1,1818,yvbK
7534,gene,3476042,3476510,gene,1,468,yvbK
7535,CDS,3476042,3476510,CDS,1,468,eno
7536,gene,3476554,3477847,gene,-1,1293,eno
7537,CDS,3476554,3477847,CDS,-1,1293,pgm
7539,CDS,3477876,3479412,CDS,-1,1536,tpiA
7538,gene,3477876,3479412,gene,-1,1536,pgm
7540,gene,3479404,3480166,gene,-1,762,tpiA
7541,CDS,3479404,3480166,CDS,-1,762,pgk
7542,gene,3480196,3481381,gene,-1,1185,pgk
7543,CDS,3480196,3481381,CDS,-1,1185,gapA
7544,gene,3481697,3482705,gene,-1,1008,gapA
7545,CDS,3481697,3482705,CDS,-1,1008,cggR
7546,gene,3482751,3483774,gene,-1,1023,cggR
7547,CDS,3482751,3483774,CDS,-1,1023,araE
7549,CDS,3484071,3485466,CDS,-1,1395,araR
7548,gene,3484071,3485466,gene,-1,1395,araE
7550,gene,3485669,3486758,gene,1,1089,araR
7551,CDS,3485669,3486758,CDS,1,1089,yvbT
7552,gene,3486806,3487817,gene,-1,1011,yvbT
7553,CDS,3486806,3487817,CDS,-1,1011,yvbU
7554,gene,3487973,3488852,gene,-1,879,yvbU
7555,CDS,3487973,3488852,CDS,-1,879,cyeB
7557,CDS,3488951,3489869,CDS,1,918,yvbW
7556,gene,3488951,3489869,gene,1,918,cyeB
7558,gene,3489909,3491253,gene,-1,1344,yvbW
7559,CDS,3489909,3491253,CDS,-1,1344,tboX
7560,gene,3491321,3491557,gene,-1,236,tboX
7561,misc_RNA,3491321,3491557,else,-1,236,yvbX
7562,gene,3491654,3492689,gene,-1,1035,yvbX
7563,CDS,3491654,3492689,CDS,-1,1035,lutC
7564,gene,3492796,3493519,gene,-1,723,lutC
7565,CDS,3492796,3493519,CDS,-1,723,lutB
7567,CDS,3493518,3494958,CDS,-1,1440,lutA
7566,gene,3493518,3494958,gene,-1,1440,lutB
7568,gene,3494984,3495701,gene,-1,717,lutA
7569,CDS,3494984,3495701,CDS,-1,717,yvfU
7570,gene,3495875,3496478,gene,-1,603,yvfU
7571,CDS,3495875,3496478,CDS,-1,603,yvfT
7572,gene,3496494,3497610,gene,-1,1116,yvfT
7573,CDS,3496494,3497610,CDS,-1,1116,yvfS
7574,gene,3497613,3498351,gene,-1,738,yvfS
7575,CDS,3497613,3498351,CDS,-1,738,yvfR
7576,gene,3498351,3499257,gene,-1,906,yvfR
7577,CDS,3498351,3499257,CDS,-1,906,rsbQ
7578,gene,3499540,3500350,gene,1,810,rsbQ
7579,CDS,3499540,3500350,CDS,1,810,rsbP
7580,gene,3500385,3501597,gene,1,1212,rsbP
7581,CDS,3500385,3501597,CDS,1,1212,ganB
7583,CDS,3501650,3502940,CDS,-1,1290,ganA
7582,gene,3501650,3502940,gene,-1,1290,ganB
7585,CDS,3503019,3505083,CDS,-1,2064,ganQ
7584,gene,3503019,3505083,gene,-1,2064,ganA
7586,gene,3505101,3505953,gene,-1,852,ganQ
7587,CDS,3505101,3505953,CDS,-1,852,ganP
7588,gene,3505956,3507213,gene,-1,1257,ganP
7589,CDS,3505956,3507213,CDS,-1,1257,ganS
7590,gene,3507252,3508518,gene,-1,1266,ganS
7591,CDS,3507252,3508518,CDS,-1,1266,ganR
7592,gene,3508658,3509651,gene,-1,993,ganR
7593,CDS,3508658,3509651,CDS,-1,993,lutR
7594,gene,3509830,3510490,gene,-1,660,lutR
7595,CDS,3509830,3510490,CDS,-1,660,lutP
7596,gene,3510779,3512471,gene,1,1692,lutP
7597,CDS,3510779,3512471,CDS,1,1692,sigL
7598,gene,3512497,3513808,gene,-1,1311,sigL
7599,CDS,3512497,3513808,CDS,-1,1311,yvfG
7601,CDS,3513886,3514105,CDS,1,219,epsO
7600,gene,3513886,3514105,gene,1,219,yvfG
7602,gene,3514114,3515083,gene,-1,969,epsO
7603,CDS,3514114,3515083,CDS,-1,969,epsN
7604,gene,3515061,3516228,gene,-1,1167,epsN
7605,CDS,3515061,3516228,CDS,-1,1167,epsM
7606,gene,3516232,3516883,gene,-1,651,epsM
7607,CDS,3516232,3516883,CDS,-1,651,epsL
7609,CDS,3516879,3517488,CDS,-1,609,epsK
7608,gene,3516879,3517488,gene,-1,609,epsL
7610,gene,3517484,3519002,gene,-1,1518,epsK
7611,CDS,3517484,3519002,CDS,-1,1518,epsJ
7612,gene,3518998,3520033,gene,-1,1035,epsJ
7613,CDS,3518998,3520033,CDS,-1,1035,epsI
7614,gene,3520029,3521106,gene,-1,1077,epsI
7615,CDS,3520029,3521106,CDS,-1,1077,epsH
7616,gene,3521110,3522145,gene,-1,1035,epsH
7617,CDS,3521110,3522145,CDS,-1,1035,epsG
7619,CDS,3522169,3523273,CDS,-1,1104,epsF
7618,gene,3522169,3523273,gene,-1,1104,epsG
7620,gene,3523269,3524424,gene,-1,1155,epsF
7621,CDS,3523269,3524424,CDS,-1,1155,epsE
7622,gene,3524416,3525253,gene,-1,837,epsE
7623,CDS,3524416,3525253,CDS,-1,837,epsD
7624,gene,3525249,3526395,gene,-1,1146,epsD
7625,CDS,3525249,3526395,CDS,-1,1146,epsC
7627,CDS,3526406,3528203,CDS,-1,1797,epsB
7626,gene,3526406,3528203,gene,-1,1797,epsC
7628,gene,3528461,3529145,gene,-1,684,epsB
7629,CDS,3528461,3529145,CDS,-1,684,epsA
7630,gene,3529150,3529855,gene,-1,705,epsA
7631,CDS,3529150,3529855,CDS,-1,705,slrR
7632,gene,3530100,3530559,gene,1,459,slrR
7633,CDS,3530100,3530559,CDS,1,459,pnbA
7634,gene,3530634,3532104,gene,1,1470,pnbA
7635,CDS,3530634,3532104,CDS,1,1470,BSU_34399
7637,CDS,3532106,3532298,CDS,1,192,padC
7636,gene,3532106,3532298,gene,1,192,BSU_34399
7638,gene,3532324,3532810,gene,-1,486,padC
7639,CDS,3532324,3532810,CDS,-1,486,yveG
7640,gene,3532832,3533144,gene,-1,312,yveG
7641,misc_feature,3532832,3533144,else,-1,312,yveF
7642,gene,3533195,3533288,gene,-1,93,yveF
7643,misc_feature,3533195,3533288,else,-1,93,racX
7644,gene,3533418,3534102,gene,-1,684,racX
7645,CDS,3533418,3534102,CDS,-1,684,pbpE
7646,gene,3534117,3535473,gene,-1,1356,pbpE
7647,CDS,3534117,3535473,CDS,-1,1356,sacB
7648,gene,3536011,3537433,gene,1,1422,sacB
7649,CDS,3536011,3537433,CDS,1,1422,levB
7650,gene,3537506,3539057,gene,1,1551,levB
7651,CDS,3537506,3539057,CDS,1,1551,aspP
7652,gene,3539164,3540727,gene,1,1563,aspP
7653,CDS,3539164,3540727,CDS,1,1563,yvdT
7655,CDS,3540716,3541406,CDS,1,690,psmA
7654,gene,3540716,3541406,gene,1,690,yvdT
7657,CDS,3541487,3541823,CDS,1,336,psmB
7656,gene,3541487,3541823,gene,1,336,psmA
7658,gene,3541822,3542143,gene,1,321,psmB
7659,CDS,3541822,3542143,CDS,1,321,yvdQ
7660,gene,3542178,3542691,gene,-1,513,yvdQ
7661,CDS,3542178,3542691,CDS,-1,513,cotNP
7662,gene,3542942,3544286,gene,-1,1344,cotNP
7663,CDS,3542942,3544286,CDS,-1,1344,cotR
7664,gene,3544641,3545604,gene,1,963,cotR
7665,CDS,3544641,3545604,CDS,1,963,trnQ-Arg
7667,tRNA,3545888,3545964,else,-1,76,clpP
7666,gene,3545888,3545964,gene,-1,76,trnQ-Arg
7668,gene,3546233,3546827,gene,1,594,clpP
7669,CDS,3546233,3546827,CDS,1,594,mdxM
7670,gene,3546872,3547553,gene,-1,681,mdxM
7671,CDS,3546872,3547553,CDS,-1,681,mdxL
7672,gene,3547549,3549235,gene,-1,1686,mdxL
7673,CDS,3547549,3549235,CDS,-1,1686,mdxK
7675,CDS,3549227,3551501,CDS,-1,2274,mdxJ
7674,gene,3549227,3551501,gene,-1,2274,mdxK
7676,gene,3551478,3552363,gene,-1,885,mdxJ
7677,CDS,3551478,3552363,CDS,-1,885,mdxG
7678,gene,3552368,3553205,gene,-1,837,mdxG
7679,CDS,3552368,3553205,CDS,-1,837,mdxF
7680,gene,3553205,3554513,gene,-1,1308,mdxF
7681,CDS,3553205,3554513,CDS,-1,1308,mdxE
7682,gene,3554552,3555806,gene,-1,1254,mdxE
7683,CDS,3554552,3555806,CDS,-1,1254,mdxD
7684,gene,3555901,3557671,gene,-1,1770,mdxD
7685,CDS,3555901,3557671,CDS,-1,1770,mdxR
7686,gene,3557783,3558734,gene,-1,951,mdxR
7687,CDS,3557783,3558734,CDS,-1,951,yvdD
7688,gene,3558939,3559515,gene,-1,576,yvdD
7689,CDS,3558939,3559515,CDS,-1,576,yvdC
7690,gene,3559631,3559952,gene,1,321,yvdC
7691,CDS,3559631,3559952,CDS,1,321,yvdB
7693,CDS,3559978,3561571,CDS,-1,1593,yvdA
7692,gene,3559978,3561571,gene,-1,1593,yvdB
7694,gene,3561589,3562183,gene,-1,594,yvdA
7695,CDS,3561589,3562183,CDS,-1,594,yvcT
7696,gene,3562565,3563543,gene,1,978,yvcT
7697,CDS,3562565,3563543,CDS,1,978,psdB
7698,gene,3563580,3565521,gene,-1,1941,psdB
7699,CDS,3563580,3565521,CDS,-1,1941,psdA
7701,CDS,3565495,3566275,CDS,-1,780,psdS
7700,gene,3565495,3566275,gene,-1,780,psdA
7702,gene,3566357,3567428,gene,-1,1071,psdS
7703,CDS,3566357,3567428,CDS,-1,1071,psdR
7704,gene,3567421,3568135,gene,-1,714,psdR
7705,CDS,3567421,3568135,CDS,-1,714,yvzJ
7706,gene,3568281,3568491,gene,1,210,yvzJ
7707,CDS,3568281,3568491,CDS,1,210,yvcN
7708,gene,3568526,3569291,gene,-1,765,yvcN
7709,CDS,3568526,3569291,CDS,-1,765,crh
7711,CDS,3569291,3569549,CDS,-1,258,whiA
7710,gene,3569291,3569549,gene,-1,258,crh
7712,gene,3569572,3570523,gene,-1,951,whiA
7713,CDS,3569572,3570523,CDS,-1,951,mgfK
7714,gene,3570545,3571499,gene,-1,954,mgfK
7715,CDS,3570545,3571499,CDS,-1,954,yvcJ
7716,gene,3571500,3572388,gene,-1,888,yvcJ
7717,CDS,3571500,3572388,CDS,-1,888,yvcI
7718,gene,3572412,3572889,gene,-1,477,yvcI
7719,CDS,3572412,3572889,CDS,-1,477,trxB
7720,gene,3573206,3574157,gene,-1,951,trxB
7721,CDS,3573206,3574157,CDS,-1,951,cwlO
7722,gene,3574362,3575784,gene,-1,1422,cwlO
7723,CDS,3574362,3575784,CDS,-1,1422,yvcD
7724,gene,3576164,3577619,gene,-1,1455,yvcD
7725,CDS,3576164,3577619,CDS,-1,1455,bmrA
7727,CDS,3577744,3579514,CDS,-1,1770,yvzA
7726,gene,3577744,3579514,gene,-1,1770,bmrA
7729,CDS,3579678,3580038,CDS,-1,360,yvcB
7728,gene,3579678,3580038,gene,-1,360,yvzA
7730,gene,3580052,3581963,gene,-1,1911,yvcB
7731,CDS,3580052,3581963,CDS,-1,1911,yvcA
7732,gene,3581964,3582690,gene,-1,726,yvcA
7733,CDS,3581964,3582690,CDS,-1,726,hisIE
7734,gene,3582935,3583565,gene,-1,630,hisIE
7735,CDS,3582935,3583565,CDS,-1,630,hisF
7736,gene,3583561,3584320,gene,-1,759,hisF
7737,CDS,3583561,3584320,CDS,-1,759,hisA
7738,gene,3584316,3585054,gene,-1,738,hisA
7739,CDS,3584316,3585054,CDS,-1,738,hisH
7740,gene,3585050,3585689,gene,-1,639,hisH
7741,CDS,3585050,3585689,CDS,-1,639,hisB
7742,gene,3585689,3586274,gene,-1,585,hisB
7743,CDS,3585689,3586274,CDS,-1,585,hisD
7744,gene,3586270,3587554,gene,-1,1284,hisD
7745,CDS,3586270,3587554,CDS,-1,1284,hisG
7747,CDS,3587550,3588192,CDS,-1,642,hisZ
7746,gene,3587550,3588192,gene,-1,642,hisG
7748,gene,3588184,3589360,gene,-1,1176,hisZ
7749,CDS,3588184,3589360,CDS,-1,1176,yvpB
7750,gene,3589610,3590363,gene,1,753,yvpB
7751,CDS,3589610,3590363,CDS,1,753,pelC
7752,gene,3590602,3591268,gene,1,666,pelC
7753,CDS,3590602,3591268,CDS,1,666,hprF
7755,CDS,3591287,3591806,CDS,-1,519,ppaX
7754,gene,3591287,3591806,gene,-1,519,hprF
7756,gene,3591809,3592460,gene,-1,651,ppaX
7757,CDS,3591809,3592460,CDS,-1,651,yvoD
7758,gene,3592456,3593395,gene,-1,939,yvoD
7759,CDS,3592456,3593395,CDS,-1,939,lgt
7760,gene,3593418,3594228,gene,-1,810,lgt
7761,CDS,3593418,3594228,CDS,-1,810,hprK
7763,CDS,3594241,3595174,CDS,-1,933,nagA
7762,gene,3594241,3595174,gene,-1,933,hprK
7765,CDS,3595355,3596546,CDS,1,1191,nagBA
7764,gene,3595355,3596546,gene,1,1191,nagA
7766,gene,3596542,3597271,gene,1,729,nagBA
7767,CDS,3596542,3597271,CDS,1,729,nagR
7768,gene,3597288,3598020,gene,1,732,nagR
7769,CDS,3597288,3598020,CDS,1,732,yvnB
7770,gene,3598039,3601909,gene,-1,3870,yvnB
7771,CDS,3598039,3601909,CDS,-1,3870,yvnA
7772,gene,3602073,3602547,gene,1,474,yvnA
7773,CDS,3602073,3602547,CDS,1,474,cypX
7775,CDS,3602587,3603805,CDS,-1,1218,pchC
7774,gene,3602587,3603805,gene,-1,1218,cypX
7776,gene,3603820,3604567,gene,-1,747,pchC
7777,CDS,3603820,3604567,CDS,-1,747,pchR
7778,gene,3604992,3605502,gene,1,510,pchR
7779,CDS,3604992,3605502,CDS,1,510,pchE
7780,gene,3605522,3606734,gene,1,1212,pchE
7781,CDS,3605522,3606734,CDS,1,1212,yvlD
7783,CDS,3606761,3607121,CDS,-1,360,yvlC
7782,gene,3606761,3607121,gene,-1,360,yvlD
7784,gene,3607122,3607320,gene,-1,198,yvlC
7785,CDS,3607122,3607320,CDS,-1,198,yvlB
7786,gene,3607324,3608422,gene,-1,1098,yvlB
7787,CDS,3607324,3608422,CDS,-1,1098,yvlA
7788,gene,3608446,3608773,gene,-1,327,yvlA
7789,CDS,3608446,3608773,CDS,-1,327,yvkN
7790,gene,3608990,3609221,gene,1,231,yvkN
7791,CDS,3608990,3609221,CDS,1,231,yvzB
7792,gene,3609419,3609902,gene,-1,483,yvzB
7793,misc_feature,3609419,3609902,else,-1,483,uvrA
7794,gene,3610063,3612937,gene,-1,2874,uvrA
7795,CDS,3610063,3612937,CDS,-1,2874,uvrB
7796,gene,3612944,3614930,gene,-1,1986,uvrB
7797,CDS,3612944,3614930,CDS,-1,1986,csbA
7799,CDS,3615115,3615346,CDS,-1,231,yvkC
7798,gene,3615115,3615346,gene,-1,231,csbA
7800,gene,3615792,3618288,gene,1,2496,yvkC
7801,CDS,3615792,3618288,CDS,1,2496,yvkB
7802,gene,3618363,3618933,gene,1,570,yvkB
7803,CDS,3618363,3618933,CDS,1,570,yvkA
7804,gene,3618963,3620298,gene,1,1335,yvkA
7805,CDS,3618963,3620298,CDS,1,1335,minJ
7806,gene,3620345,3621539,gene,-1,1194,minJ
7807,CDS,3620345,3621539,CDS,-1,1194,swrAAc
7808,gene,3621617,3621956,gene,-1,339,swrAAc
7809,misc_feature,3621617,3621956,else,-1,339,swrAAn
7810,gene,3621930,3622047,gene,-1,117,swrAAn
7811,misc_feature,3621930,3622047,else,-1,117,ctpB
7812,gene,3622355,3623798,gene,-1,1443,ctpB
7813,CDS,3622355,3623798,CDS,-1,1443,ftsX
7815,CDS,3623937,3624828,CDS,-1,891,ftsE
7814,gene,3623937,3624828,gene,-1,891,ftsX
7816,gene,3624820,3625507,gene,-1,687,ftsE
7817,CDS,3624820,3625507,CDS,-1,687,cccB
7818,gene,3625740,3626079,gene,-1,339,cccB
7819,CDS,3625740,3626079,CDS,-1,339,yvjA
7820,gene,3626127,3627012,gene,-1,885,yvjA
7821,CDS,3626127,3627012,CDS,-1,885,prfB
7823,CDS,3627138,3628240,CDS,-1,1102,secA
7822,gene,3627138,3628240,gene,-1,1102,prfB
7824,gene,3628309,3630835,gene,-1,2526,secA
7825,CDS,3628309,3630835,CDS,-1,2526,hpf
7826,gene,3631002,3631572,gene,-1,570,hpf
7827,CDS,3631002,3631572,CDS,-1,570,yvzG
7828,gene,3631762,3632140,gene,-1,378,yvzG
7829,CDS,3631762,3632140,CDS,-1,378,fliT
7830,gene,3632149,3632491,gene,-1,342,fliT
7831,CDS,3632149,3632491,CDS,-1,342,fliS
7833,CDS,3632487,3632889,CDS,-1,402,fliD
7832,gene,3632487,3632889,gene,-1,402,fliS
7834,gene,3632910,3634407,gene,-1,1497,fliD
7835,CDS,3632910,3634407,CDS,-1,1497,yvyC
7836,gene,3634424,3634754,gene,-1,330,yvyC
7837,CDS,3634424,3634754,CDS,-1,330,hag
7838,gene,3634986,3635901,gene,-1,915,hag
7839,CDS,3634986,3635901,CDS,-1,915,csrA
7841,CDS,3636045,3636270,CDS,-1,225,fliW
7840,gene,3636045,3636270,gene,-1,225,csrA
7842,gene,3636263,3636695,gene,-1,432,fliW
7843,CDS,3636263,3636695,CDS,-1,432,yviE
7844,gene,3636715,3637291,gene,-1,576,yviE
7845,CDS,3636715,3637291,CDS,-1,576,flgL
7846,gene,3637337,3638234,gene,-1,897,flgL
7847,CDS,3637337,3638234,CDS,-1,897,flgK
7848,gene,3638244,3639768,gene,-1,1524,flgK
7849,CDS,3638244,3639768,CDS,-1,1524,flgN
7851,CDS,3639786,3640269,CDS,-1,483,flgM
7850,gene,3639786,3640269,gene,-1,483,flgN
7852,gene,3640284,3640551,gene,-1,267,flgM
7853,CDS,3640284,3640551,CDS,-1,267,yvyF
7854,gene,3640631,3641051,gene,-1,420,yvyF
7855,CDS,3640631,3641051,CDS,-1,420,comFC
7856,gene,3641124,3641847,gene,-1,723,comFC
7857,CDS,3641124,3641847,CDS,-1,723,comFB
7858,gene,3641810,3642107,gene,-1,297,comFB
7859,CDS,3641810,3642107,CDS,-1,297,comFA
7860,gene,3642166,3643558,gene,-1,1392,comFA
7861,CDS,3642166,3643558,CDS,-1,1392,fakBA
7862,gene,3643663,3644509,gene,-1,846,fakBA
7863,CDS,3643663,3644509,CDS,-1,846,degU
7864,gene,3644606,3645296,gene,-1,690,degU
7865,CDS,3644606,3645296,CDS,-1,690,degS
7866,gene,3645378,3646536,gene,-1,1158,degS
7867,CDS,3645378,3646536,CDS,-1,1158,yvyE
7869,CDS,3646752,3647406,CDS,1,654,tagV
7868,gene,3646752,3647406,gene,1,654,yvyE
7870,gene,3647405,3648581,gene,1,1176,tagV
7871,CDS,3647405,3648581,CDS,1,1176,tagO
7872,gene,3648653,3649730,gene,-1,1077,tagO
7873,CDS,3648653,3649730,CDS,-1,1077,tuaH
7874,gene,3649874,3651068,gene,-1,1194,tuaH
7875,CDS,3649874,3651068,CDS,-1,1194,tuaG
7876,gene,3651096,3651855,gene,-1,759,tuaG
7877,CDS,3651096,3651855,CDS,-1,759,tuaF
7878,gene,3651878,3652559,gene,-1,681,tuaF
7879,CDS,3651878,3652559,CDS,-1,681,tuaE
7880,gene,3652587,3654054,gene,-1,1467,tuaE
7881,CDS,3652587,3654054,CDS,-1,1467,tuaD
7882,gene,3654138,3655524,gene,-1,1386,tuaD
7883,CDS,3654138,3655524,CDS,-1,1386,tuaC
7885,CDS,3655585,3656755,CDS,-1,1170,tuaB
7884,gene,3655585,3656755,gene,-1,1170,tuaC
7886,gene,3656751,3658203,gene,-1,1452,tuaB
7887,CDS,3656751,3658203,CDS,-1,1452,tuaAc
7888,gene,3658258,3658408,gene,-1,150,tuaAc
7889,misc_feature,3658258,3658408,else,-1,150,tuaAn
7890,gene,3658406,3658892,gene,-1,486,tuaAn
7891,misc_feature,3658406,3658892,else,-1,486,lytC
7893,CDS,3659118,3660609,CDS,-1,1491,lytB
7892,gene,3659118,3660609,gene,-1,1491,lytC
7894,gene,3660647,3662765,gene,-1,2118,lytB
7895,CDS,3660647,3662765,CDS,-1,2118,lytA
7896,gene,3662788,3663097,gene,-1,309,lytA
7897,CDS,3662788,3663097,CDS,-1,309,tagU
7898,gene,3663280,3664201,gene,1,921,tagU
7899,CDS,3663280,3664201,CDS,1,921,mnaA
7901,CDS,3664240,3665383,CDS,-1,1143,gtaB
7900,gene,3664240,3665383,gene,-1,1143,mnaA
7903,CDS,3665628,3666507,CDS,1,879,BSU_35678
7902,gene,3665628,3666507,gene,1,879,gtaB
7904,gene,3666840,3667059,gene,1,219,BSU_35678
7905,CDS,3666840,3667059,CDS,1,219,yvzH
7906,gene,3666932,3667016,gene,-1,84,yvzH
7907,misc_feature,3666932,3667016,else,-1,84,ggaB
7908,gene,3667208,3669911,gene,-1,2703,ggaB
7909,CDS,3667208,3669911,CDS,-1,2703,ggaA
7910,gene,3670034,3671375,gene,-1,1341,ggaA
7911,misc_feature,3670034,3671375,else,-1,1341,yvzI
7912,gene,3671415,3671622,gene,-1,207,yvzI
7913,misc_feature,3671415,3671622,else,-1,207,yvzE
7914,gene,3672928,3673525,gene,1,597,yvzE
7915,misc_feature,3672928,3673525,else,1,597,tagH
7916,gene,3673563,3675147,gene,-1,1584,tagH
7917,CDS,3673563,3675147,CDS,-1,1584,tagG
7919,CDS,3675166,3675994,CDS,-1,828,tagF
7918,gene,3675166,3675994,gene,-1,828,tagG
7920,gene,3676158,3678399,gene,-1,2241,tagF
7921,CDS,3676158,3678399,CDS,-1,2241,tagE
7922,gene,3678398,3680420,gene,-1,2022,tagE
7923,CDS,3678398,3680420,CDS,-1,2022,tagD
7924,gene,3680580,3680970,gene,-1,390,tagD
7925,CDS,3680580,3680970,CDS,-1,390,tagA
7927,CDS,3681369,3682140,CDS,1,771,tagB
7926,gene,3681369,3682140,gene,1,771,tagA
7928,gene,3682172,3683318,gene,1,1146,tagB
7929,CDS,3682172,3683318,CDS,1,1146,tagC
7930,gene,3683437,3684766,gene,1,1329,tagC
7931,CDS,3683437,3684766,CDS,1,1329,lytD
7932,gene,3684825,3687468,gene,-1,2643,lytD
7933,CDS,3684825,3687468,CDS,-1,2643,pmiA
7934,gene,3687596,3688547,gene,-1,951,pmiA
7935,CDS,3687596,3688547,CDS,-1,951,gerBA
7937,CDS,3688811,3690263,CDS,1,1452,gerBB
7936,gene,3688811,3690263,gene,1,1452,gerBA
7939,CDS,3690268,3691375,CDS,1,1107,gerBC
7938,gene,3690268,3691375,gene,1,1107,gerBB
7940,gene,3691371,3692496,gene,1,1125,gerBC
7941,CDS,3691371,3692496,CDS,1,1125,ywtG
7942,gene,3692532,3693906,gene,-1,1374,ywtG
7943,CDS,3692532,3693906,CDS,-1,1374,tagT
7944,gene,3694238,3695207,gene,1,969,tagT
7945,CDS,3694238,3695207,CDS,1,969,ribZB
7946,gene,3695362,3696223,gene,1,861,ribZB
7947,CDS,3695362,3696223,CDS,1,861,pgdS
7948,gene,3696256,3697498,gene,-1,1242,pgdS
7949,CDS,3696256,3697498,CDS,-1,1242,edmS
7950,gene,3697638,3697806,gene,-1,168,edmS
7951,CDS,3697638,3697806,CDS,-1,168,capA
7952,gene,3697820,3698963,gene,-1,1143,capA
7953,CDS,3697820,3698963,CDS,-1,1143,capC
7954,gene,3698981,3699431,gene,-1,450,capC
7955,CDS,3698981,3699431,CDS,-1,450,capB
7957,CDS,3699445,3700627,CDS,-1,1182,rbsR
7956,gene,3699445,3700627,gene,-1,1182,capB
7958,gene,3701410,3702391,gene,1,981,rbsR
7959,CDS,3701410,3702391,CDS,1,981,rbsK
7960,gene,3702392,3703274,gene,1,882,rbsK
7961,CDS,3702392,3703274,CDS,1,882,rbsD
7962,gene,3703270,3703666,gene,1,396,rbsD
7963,CDS,3703270,3703666,CDS,1,396,rbsA
7965,CDS,3703681,3705163,CDS,1,1482,rbsC
7964,gene,3703681,3705163,gene,1,1482,rbsA
7966,gene,3705164,3706133,gene,1,969,rbsC
7967,CDS,3705164,3706133,CDS,1,969,rbsB
7968,gene,3706144,3707062,gene,1,918,rbsB
7969,CDS,3706144,3707062,CDS,1,918,ywsB
7970,gene,3707143,3707680,gene,1,537,ywsB
7971,CDS,3707143,3707680,CDS,1,537,ywsA
7973,CDS,3707835,3708132,CDS,1,297,ywrO
7972,gene,3707835,3708132,gene,1,297,ywsA
7975,CDS,3708171,3708699,CDS,-1,528,alsD
7974,gene,3708171,3708699,gene,-1,528,ywrO
7976,gene,3708798,3709566,gene,-1,768,alsD
7977,CDS,3708798,3709566,CDS,-1,768,alsS
7978,gene,3709627,3711340,gene,-1,1713,alsS
7979,CDS,3709627,3711340,CDS,-1,1713,alsR
7980,gene,3711497,3712406,gene,1,909,alsR
7981,CDS,3711497,3712406,CDS,1,909,ywrK
7982,gene,3712616,3713945,gene,1,1329,ywrK
7983,CDS,3712616,3713945,CDS,1,1329,ywrJ
7985,CDS,3714001,3714679,CDS,-1,678,cotB
7984,gene,3714001,3714679,gene,-1,678,ywrJ
7986,gene,3714738,3715881,gene,-1,1143,cotB
7987,CDS,3714738,3715881,CDS,-1,1143,cotH
7988,gene,3716008,3717097,gene,-1,1089,cotH
7989,CDS,3716008,3717097,CDS,-1,1089,cotG
7990,gene,3717237,3717825,gene,1,588,cotG
7991,CDS,3717237,3717825,CDS,1,588,BSU_36079
7993,CDS,3717325,3717805,CDS,1,480,ywrF
7992,gene,3717325,3717805,gene,1,480,BSU_36079
7994,gene,3717998,3718616,gene,1,618,ywrF
7995,CDS,3717998,3718616,CDS,1,618,ywrE
7996,gene,3718793,3719129,gene,1,336,ywrE
7997,CDS,3718793,3719129,CDS,1,336,hpxW
7998,gene,3719133,3720711,gene,-1,1578,hpxW
7999,CDS,3719133,3720711,CDS,-1,1578,chrS
8000,gene,3720924,3721401,gene,1,477,chrS
8001,CDS,3720924,3721401,CDS,1,477,chrB
8002,gene,3721414,3722008,gene,1,594,chrB
8003,CDS,3721414,3722008,CDS,1,594,chrA
8004,gene,3722004,3722541,gene,1,537,chrA
8005,CDS,3722004,3722541,CDS,1,537,ywqO
8006,gene,3722567,3722789,gene,-1,222,ywqO
8007,CDS,3722567,3722789,CDS,-1,222,ywqN
8009,CDS,3722785,3723331,CDS,-1,546,ywqM
8008,gene,3722785,3723331,gene,-1,546,ywqN
8010,gene,3723453,3724335,gene,1,882,ywqM
8011,CDS,3723453,3724335,CDS,1,882,nfi
8012,gene,3724419,3725136,gene,-1,717,nfi
8013,CDS,3724419,3725136,CDS,-1,717,rttO
8014,gene,3725145,3725610,gene,-1,465,rttO
8015,CDS,3725145,3725610,CDS,-1,465,rttN
8016,gene,3725599,3727408,gene,-1,1809,rttN
8017,CDS,3725599,3727408,CDS,-1,1809,ywqI
8018,gene,3727426,3727687,gene,-1,261,ywqI
8019,CDS,3727426,3727687,CDS,-1,261,ywqH
8020,gene,3727696,3728119,gene,-1,423,ywqH
8021,CDS,3727696,3728119,CDS,-1,423,BSU_36215
8022,gene,3728335,3728461,gene,-1,126,BSU_36215
8023,CDS,3728335,3728461,CDS,-1,126,ywqG
8025,CDS,3728510,3729296,CDS,-1,786,uglF
8024,gene,3728510,3729296,gene,-1,786,ywqG
8026,gene,3729487,3730810,gene,-1,1323,uglF
8027,CDS,3729487,3730810,CDS,-1,1323,ptpZ
8028,gene,3731004,3731769,gene,-1,765,ptpZ
8029,CDS,3731004,3731769,CDS,-1,765,ptkA
8030,gene,3731821,3732535,gene,-1,714,ptkA
8031,CDS,3731821,3732535,CDS,-1,714,tkmA
8033,CDS,3732524,3733271,CDS,-1,747,ywzD
8032,gene,3732524,3733271,gene,-1,747,tkmA
8034,gene,3733504,3733648,gene,-1,144,ywzD
8035,CDS,3733504,3733648,CDS,-1,144,ywqB
8036,gene,3733851,3735462,gene,1,1611,ywqB
8037,CDS,3733851,3735462,CDS,1,1611,hepA
8038,gene,3735448,3738217,gene,1,2769,hepA
8039,CDS,3735448,3738217,CDS,1,2769,ywpJ
8040,gene,3738342,3739200,gene,-1,858,ywpJ
8041,CDS,3738342,3739200,CDS,-1,858,glcR
8043,CDS,3739205,3739982,CDS,-1,777,ssbB
8042,gene,3739205,3739982,gene,-1,777,glcR
8044,gene,3740205,3740547,gene,-1,342,ssbB
8045,CDS,3740205,3740547,CDS,-1,342,ywpG
8046,gene,3740623,3741007,gene,-1,384,ywpG
8047,CDS,3740623,3741007,CDS,-1,384,ywpF
8048,gene,3741181,3741592,gene,1,411,ywpF
8049,CDS,3741181,3741592,CDS,1,411,ywpE
8051,CDS,3741731,3742040,CDS,-1,309,ywpD
8050,gene,3741731,3742040,gene,-1,309,ywpE
8052,gene,3742383,3743220,gene,1,837,ywpD
8053,CDS,3742383,3743220,CDS,1,837,mscL
8054,gene,3743266,3743659,gene,-1,393,mscL
8055,CDS,3743266,3743659,CDS,-1,393,fabZ
8056,gene,3743731,3744157,gene,-1,426,fabZ
8057,CDS,3743731,3744157,CDS,-1,426,rapD
8058,gene,3744348,3745413,gene,1,1065,rapD
8059,CDS,3744348,3745413,CDS,1,1065,flhP
8061,CDS,3745435,3746245,CDS,-1,810,flhO
8060,gene,3745435,3746245,gene,-1,810,flhP
8062,gene,3746278,3747091,gene,-1,813,flhO
8063,CDS,3746278,3747091,CDS,-1,813,mbl
8064,gene,3747253,3748255,gene,-1,1002,mbl
8065,CDS,3747253,3748255,CDS,-1,1002,spoIIID
8066,gene,3748420,3748702,gene,-1,282,spoIIID
8067,CDS,3748420,3748702,CDS,-1,282,usd
8068,gene,3748716,3748827,gene,-1,111,usd
8069,CDS,3748716,3748827,CDS,-1,111,ywoH
8070,gene,3749051,3749465,gene,1,414,ywoH
8071,CDS,3749051,3749465,CDS,1,414,ywoG
8072,gene,3749486,3750677,gene,1,1191,ywoG
8073,CDS,3749486,3750677,CDS,1,1191,ywoF
8074,gene,3750767,3752174,gene,-1,1407,ywoF
8075,CDS,3750767,3752174,CDS,-1,1407,pucI
8076,gene,3752279,3753752,gene,-1,1473,pucI
8077,CDS,3752279,3753752,CDS,-1,1473,ywoD
8079,CDS,3753932,3755291,CDS,-1,1359,ywoC
8078,gene,3753932,3755291,gene,-1,1359,ywoD
8080,gene,3755290,3755860,gene,-1,570,ywoC
8081,CDS,3755290,3755860,CDS,-1,570,BSU_36499
8082,gene,3755966,3756134,gene,-1,168,BSU_36499
8083,misc_feature,3755966,3756134,else,-1,168,ywoB
8084,gene,3756043,3756508,gene,-1,465,ywoB
8085,CDS,3756043,3756508,CDS,-1,465,amtB
8086,gene,3756789,3758004,gene,1,1215,amtB
8087,CDS,3756789,3758004,CDS,1,1215,glnK
8088,gene,3758015,3758366,gene,1,351,glnK
8089,CDS,3758015,3758366,CDS,1,351,bcrC
8090,gene,3758546,3759128,gene,1,582,bcrC
8091,CDS,3758546,3759128,CDS,1,582,ywnJ
8092,gene,3759168,3759591,gene,-1,423,ywnJ
8093,CDS,3759168,3759591,CDS,-1,423,spoIIQ
8095,CDS,3759701,3760553,CDS,-1,852,ywnH
8094,gene,3759701,3760553,gene,-1,852,spoIIQ
8096,gene,3760693,3761185,gene,1,492,ywnH
8097,CDS,3760693,3761185,CDS,1,492,ywnG
8098,gene,3761181,3761700,gene,1,519,ywnG
8099,CDS,3761181,3761700,CDS,1,519,BSU_36575
8100,gene,3761858,3761990,gene,1,132,BSU_36575
8101,CDS,3761858,3761990,CDS,1,132,ywnF
8103,CDS,3761986,3762421,CDS,-1,435,clsA
8102,gene,3761986,3762421,gene,-1,435,ywnF
8104,gene,3762663,3764112,gene,1,1449,clsA
8105,CDS,3762663,3764112,CDS,1,1449,mta
8106,gene,3764132,3764906,gene,-1,774,mta
8107,CDS,3764132,3764906,CDS,-1,774,ywnC
8108,gene,3765050,3765434,gene,1,384,ywnC
8109,CDS,3765050,3765434,CDS,1,384,ywnB
8110,gene,3765468,3766110,gene,-1,642,ywnB
8111,CDS,3765468,3766110,CDS,-1,642,ywnA
8113,CDS,3766177,3766579,CDS,-1,402,ureC
8112,gene,3766177,3766579,gene,-1,402,ywnA
8114,gene,3766713,3768423,gene,-1,1710,ureC
8115,CDS,3766713,3768423,CDS,-1,1710,ureB
8116,gene,3768419,3768794,gene,-1,375,ureB
8117,CDS,3768419,3768794,CDS,-1,375,ureA
8118,gene,3768790,3769108,gene,-1,318,ureA
8119,CDS,3768790,3769108,CDS,-1,318,ywzE
8121,CDS,3769288,3769453,CDS,-1,165,ywzF
8120,gene,3769288,3769453,gene,-1,165,ywzE
8122,gene,3769625,3769808,gene,-1,183,ywzF
8123,misc_feature,3769625,3769808,else,-1,183,csbD
8124,gene,3770103,3770292,gene,-1,189,csbD
8125,CDS,3770103,3770292,CDS,-1,189,ywmF
8126,gene,3770364,3770865,gene,-1,501,ywmF
8127,CDS,3770364,3770865,CDS,-1,501,rapB
8128,gene,3770999,3772133,gene,-1,1134,rapB
8129,CDS,3770999,3772133,CDS,-1,1134,moaA
8131,CDS,3772324,3773350,CDS,-1,1026,fdhD
8130,gene,3772324,3773350,gene,-1,1026,moaA
8132,gene,3773365,3774154,gene,-1,789,fdhD
8133,CDS,3773365,3774154,CDS,-1,789,ywmE
8134,gene,3774399,3774561,gene,-1,162,ywmE
8135,CDS,3774399,3774561,CDS,-1,162,ywmD
8136,gene,3774654,3775329,gene,-1,675,ywmD
8137,CDS,3774654,3775329,CDS,-1,675,BSU_36739
8138,gene,3775381,3775522,gene,-1,141,BSU_36739
8139,CDS,3775381,3775522,CDS,-1,141,ywmC
8140,gene,3775652,3776336,gene,-1,684,ywmC
8141,CDS,3775652,3776336,CDS,-1,684,spoIID
8142,gene,3776721,3777753,gene,-1,1032,spoIID
8143,CDS,3776721,3777753,CDS,-1,1032,murAA
8144,gene,3777948,3779259,gene,-1,1311,murAA
8145,CDS,3777948,3779259,CDS,-1,1311,ywmB
8147,CDS,3779292,3780033,CDS,-1,741,ywzB
8146,gene,3779292,3780033,gene,-1,741,ywmB
8149,CDS,3780161,3780392,CDS,-1,231,ywmA
8148,gene,3780161,3780392,gene,-1,231,ywzB
8150,gene,3780561,3781035,gene,1,474,ywmA
8151,CDS,3780561,3781035,CDS,1,474,atpC
8152,gene,3781068,3781467,gene,-1,399,atpC
8153,CDS,3781068,3781467,CDS,-1,399,atpD
8154,gene,3781490,3782912,gene,-1,1422,atpD
8155,CDS,3781490,3782912,CDS,-1,1422,atpG
8156,gene,3782937,3783801,gene,-1,864,atpG
8157,CDS,3782937,3783801,CDS,-1,864,atpA
8158,gene,3783877,3785386,gene,-1,1509,atpA
8159,CDS,3783877,3785386,CDS,-1,1509,atpH
8160,gene,3785402,3785948,gene,-1,546,atpH
8161,CDS,3785402,3785948,CDS,-1,546,atpF
8162,gene,3785944,3786457,gene,-1,513,atpF
8163,CDS,3785944,3786457,CDS,-1,513,atpE
8165,CDS,3786619,3786832,CDS,-1,213,atpB
8164,gene,3786619,3786832,gene,-1,213,atpE
8166,gene,3786877,3787612,gene,-1,735,atpB
8167,CDS,3786877,3787612,CDS,-1,735,atpI
8168,gene,3787619,3788003,gene,-1,384,atpI
8169,CDS,3787619,3788003,CDS,-1,384,upp
8170,gene,3788425,3789055,gene,-1,630,upp
8171,CDS,3788425,3789055,CDS,-1,630,glyA
8173,CDS,3789189,3790437,CDS,-1,1248,ywlG
8172,gene,3789189,3790437,gene,-1,1248,glyA
8174,gene,3790643,3791186,gene,-1,543,ywlG
8175,CDS,3790643,3791186,CDS,-1,543,rpiB
8176,gene,3791198,3791648,gene,-1,450,rpiB
8177,CDS,3791198,3791648,CDS,-1,450,prpB
8178,gene,3791804,3792257,gene,-1,453,prpB
8179,CDS,3791804,3792257,CDS,-1,453,mntP
8180,gene,3792332,3792890,gene,-1,558,mntP
8181,CDS,3792332,3792890,CDS,-1,558,tsaC
8183,CDS,3792968,3794009,CDS,-1,1041,ywlB
8182,gene,3792968,3794009,gene,-1,1041,tsaC
8184,gene,3794165,3794609,gene,-1,444,ywlB
8185,CDS,3794165,3794609,CDS,-1,444,spoIIR
8186,gene,3794675,3795350,gene,-1,675,spoIIR
8187,CDS,3794675,3795350,CDS,-1,675,ywlA
8188,gene,3795490,3795853,gene,1,363,ywlA
8189,CDS,3795490,3795853,CDS,1,363,ywkF
8191,CDS,3795869,3796157,CDS,-1,288,prmC
8190,gene,3795869,3796157,gene,-1,288,ywkF
8192,gene,3796216,3797083,gene,-1,867,prmC
8193,CDS,3796216,3797083,CDS,-1,867,prfA
8194,gene,3797084,3798155,gene,-1,1071,prfA
8195,CDS,3797084,3798155,CDS,-1,1071,ywkD
8196,gene,3798280,3798667,gene,1,387,ywkD
8197,CDS,3798280,3798667,CDS,1,387,racA
8198,gene,3798788,3799343,gene,1,555,racA
8199,CDS,3798788,3799343,CDS,1,555,ywkB
8201,CDS,3799376,3800336,CDS,-1,960,maeA
8200,gene,3799376,3800336,gene,-1,960,ywkB
8202,gene,3800417,3802166,gene,-1,1749,maeA
8203,CDS,3800417,3802166,CDS,-1,1749,tdk
8204,gene,3802404,3802992,gene,-1,588,tdk
8205,CDS,3802404,3802992,CDS,-1,588,rpmEA
8206,gene,3803080,3803281,gene,-1,201,rpmEA
8207,CDS,3803080,3803281,CDS,-1,201,rho
8208,gene,3803399,3804683,gene,-1,1284,rho
8209,CDS,3803399,3804683,CDS,-1,1284,BSU_37089
8210,gene,3804713,3804875,gene,-1,162,BSU_37089
8211,CDS,3804713,3804875,CDS,-1,162,glpX
8212,gene,3805089,3806055,gene,-1,966,glpX
8213,CDS,3805089,3806055,CDS,-1,966,murAB
8214,gene,3806085,3807375,gene,-1,1290,murAB
8215,CDS,3806085,3807375,CDS,-1,1290,tal
8216,gene,3807753,3808392,gene,-1,639,tal
8217,CDS,3807753,3808392,CDS,-1,639,fbaA
8218,gene,3808511,3809369,gene,-1,858,fbaA
8219,CDS,3808511,3809369,CDS,-1,858,spo0F
8221,CDS,3809549,3809924,CDS,-1,375,ywjG
8220,gene,3809549,3809924,gene,-1,375,spo0F
8222,gene,3810089,3810611,gene,1,522,ywjG
8223,CDS,3810089,3810611,CDS,1,522,pyrG
8224,gene,3810692,3812300,gene,-1,1608,pyrG
8225,CDS,3810692,3812300,CDS,-1,1608,rpoE
8226,gene,3812541,3813063,gene,-1,522,rpoE
8227,CDS,3812541,3813063,CDS,-1,522,acdA
8228,gene,3813245,3814385,gene,-1,1140,acdA
8229,CDS,3813245,3814385,CDS,-1,1140,fadF
8230,gene,3814381,3816499,gene,-1,2118,fadF
8231,CDS,3814381,3816499,CDS,-1,2118,clsB
8232,gene,3816653,3817850,gene,1,1197,clsB
8233,CDS,3816653,3817850,CDS,1,1197,uvsE
8234,gene,3817862,3818825,gene,1,963,uvsE
8235,CDS,3817862,3818825,CDS,1,963,ywjC
8237,CDS,3818905,3819178,CDS,1,273,ywjB
8236,gene,3818905,3819178,gene,1,273,ywjC
8238,gene,3819219,3819744,gene,-1,525,ywjB
8239,CDS,3819219,3819744,CDS,-1,525,ywjA
8240,gene,3819753,3821481,gene,-1,1728,ywjA
8241,CDS,3819753,3821481,CDS,-1,1728,clsC
8242,gene,3821569,3823072,gene,-1,1503,clsC
8243,CDS,3821569,3823072,CDS,-1,1503,narI
8245,CDS,3823557,3824229,CDS,-1,672,narJ
8244,gene,3823557,3824229,gene,-1,672,narI
8246,gene,3824225,3824780,gene,-1,555,narJ
8247,CDS,3824225,3824780,CDS,-1,555,narH
8248,gene,3824805,3826269,gene,-1,1464,narH
8249,CDS,3824805,3826269,CDS,-1,1464,narG
8250,gene,3826258,3829945,gene,-1,3687,narG
8251,CDS,3826258,3829945,CDS,-1,3687,arfM
8252,gene,3830140,3830617,gene,-1,477,arfM
8253,CDS,3830140,3830617,CDS,-1,477,ywiC
8255,CDS,3830760,3831480,CDS,1,720,fnr
8254,gene,3830760,3831480,gene,1,720,ywiC
8256,gene,3831511,3832228,gene,-1,717,fnr
8257,CDS,3831511,3832228,CDS,-1,717,narK
8258,gene,3832326,3833514,gene,-1,1188,narK
8259,CDS,3832326,3833514,CDS,-1,1188,argS
8260,gene,3833649,3835320,gene,-1,1671,argS
8261,CDS,3833649,3835320,CDS,-1,1671,ywiB
8263,CDS,3835316,3835745,CDS,-1,429,sboA
8262,gene,3835316,3835745,gene,-1,429,ywiB
8264,gene,3836057,3836189,gene,1,132,sboA
8265,CDS,3836057,3836189,CDS,1,132,sboX
8266,gene,3836145,3836298,gene,1,153,sboX
8267,CDS,3836145,3836298,CDS,1,153,albA
8268,gene,3836322,3837669,gene,1,1347,albA
8269,CDS,3836322,3837669,CDS,1,1347,albB
8270,gene,3837681,3837843,gene,1,162,albB
8271,CDS,3837681,3837843,CDS,1,162,albC
8273,CDS,3837839,3838559,CDS,1,720,albD
8272,gene,3837839,3838559,gene,1,720,albC
8274,gene,3838551,3839862,gene,1,1311,albD
8275,CDS,3838551,3839862,CDS,1,1311,albE
8276,gene,3839851,3841012,gene,1,1161,albE
8277,CDS,3839851,3841012,CDS,1,1161,albF
8278,gene,3841016,3842297,gene,1,1281,albF
8279,CDS,3841016,3842297,CDS,1,1281,albG
8280,gene,3842293,3842995,gene,1,702,albG
8281,CDS,3842293,3842995,CDS,1,702,ywhL
8282,gene,3843000,3844377,gene,-1,1377,ywhL
8283,CDS,3843000,3844377,CDS,-1,1377,ywhK
8284,gene,3844415,3845771,gene,-1,1356,ywhK
8285,CDS,3844415,3845771,CDS,-1,1356,rapF
8286,gene,3846000,3847146,gene,1,1146,rapF
8287,CDS,3846000,3847146,CDS,1,1146,phrF
8288,gene,3847129,3847249,gene,1,120,phrF
8289,CDS,3847129,3847249,CDS,1,120,ywhH
8291,CDS,3847347,3847821,CDS,1,474,speB
8290,gene,3847347,3847821,gene,1,474,ywhH
8292,gene,3847852,3848725,gene,-1,873,speB
8293,CDS,3847852,3848725,CDS,-1,873,speE
8294,gene,3848785,3849616,gene,-1,831,speE
8295,CDS,3848785,3849616,CDS,-1,831,pbpG
8296,gene,3849817,3851893,gene,1,2076,pbpG
8297,CDS,3849817,3851893,CDS,1,2076,ywhD
8299,CDS,3852185,3852704,CDS,-1,519,ywhC
8298,gene,3852185,3852704,gene,-1,519,ywhD
8300,gene,3852717,3853377,gene,-1,660,ywhC
8301,CDS,3852717,3853377,CDS,-1,660,hmtB
8302,gene,3853485,3853674,gene,1,189,hmtB
8303,CDS,3853485,3853674,CDS,1,189,ywhA
8304,gene,3853716,3854136,gene,-1,420,ywhA
8305,CDS,3853716,3854136,CDS,-1,420,thrZ
8307,CDS,3854255,3856172,CDS,-1,1917,tboTB
8306,gene,3854255,3856172,gene,-1,1917,thrZ
8309,misc_RNA,3856225,3856447,else,-1,222,tboTA
8308,gene,3856225,3856447,gene,-1,222,tboTB
8310,gene,3856478,3856700,gene,-1,222,tboTA
8311,misc_RNA,3856478,3856700,else,-1,222,BSU_37569
8312,gene,3856781,3856937,gene,-1,156,BSU_37569
8313,CDS,3856781,3856937,CDS,-1,156,mmr
8314,gene,3857016,3858417,gene,-1,1401,mmr
8315,CDS,3857016,3858417,CDS,-1,1401,ywgB
8316,gene,3858416,3858887,gene,-1,471,ywgB
8317,CDS,3858416,3858887,CDS,-1,471,ywgA
8319,CDS,3858998,3859499,CDS,-1,501,ywfO
8318,gene,3858998,3859499,gene,-1,501,ywgA
8320,gene,3859534,3860836,gene,-1,1302,ywfO
8321,CDS,3859534,3860836,CDS,-1,1302,ywzC
8322,gene,3860997,3861222,gene,-1,225,ywzC
8323,CDS,3860997,3861222,CDS,-1,225,psrF
8324,gene,3861436,3862213,gene,1,777,psrF
8325,CDS,3861436,3862213,CDS,1,777,ywfM
8327,CDS,3862356,3863247,CDS,-1,891,lipL
8326,gene,3862356,3863247,gene,-1,891,ywfM
8328,gene,3863414,3864260,gene,-1,846,lipL
8329,CDS,3863414,3864260,CDS,-1,846,cysL
8330,gene,3864308,3865208,gene,-1,900,cysL
8331,CDS,3864308,3865208,CDS,-1,900,pta
8332,gene,3865354,3866326,gene,-1,972,pta
8333,CDS,3865354,3866326,CDS,-1,972,hemQ
8334,gene,3866595,3867360,gene,1,765,hemQ
8335,CDS,3866595,3867360,CDS,1,765,bacG
8336,gene,3867492,3868272,gene,1,780,bacG
8337,CDS,3867492,3868272,CDS,1,780,bacF
8338,gene,3868286,3869486,gene,-1,1200,bacF
8339,CDS,3868286,3869486,CDS,-1,1200,bacE
8340,gene,3869486,3870671,gene,-1,1185,bacE
8341,CDS,3869486,3870671,CDS,-1,1185,bacD
8343,CDS,3870667,3872086,CDS,-1,1419,bacC
8342,gene,3870667,3872086,gene,-1,1419,bacD
8344,gene,3872104,3872866,gene,-1,762,bacC
8345,CDS,3872104,3872866,CDS,-1,762,bacB
8346,gene,3872868,3873576,gene,-1,708,bacB
8347,CDS,3872868,3873576,CDS,-1,708,bacA
8348,gene,3873565,3874180,gene,-1,615,bacA
8349,CDS,3873565,3874180,CDS,-1,615,ywfA
8351,CDS,3874331,3875570,CDS,-1,1239,rocC
8350,gene,3874331,3875570,gene,-1,1239,ywfA
8352,gene,3875779,3877192,gene,-1,1413,rocC
8353,CDS,3875779,3877192,CDS,-1,1413,rocB
8354,gene,3877191,3878892,gene,-1,1701,rocB
8355,CDS,3877191,3878892,CDS,-1,1701,rocA
8356,gene,3878965,3880513,gene,-1,1548,rocA
8357,CDS,3878965,3880513,CDS,-1,1548,rocG
8358,gene,3880739,3882014,gene,-1,1275,rocG
8359,CDS,3880739,3882014,CDS,-1,1275,bslB
8361,CDS,3882190,3882655,CDS,-1,465,spsL
8360,gene,3882190,3882655,gene,-1,465,bslB
8363,CDS,3882978,3883434,CDS,-1,456,spsK
8362,gene,3882978,3883434,gene,-1,456,spsL
8364,gene,3883426,3884278,gene,-1,852,spsK
8365,CDS,3883426,3884278,CDS,-1,852,spsJ
8366,gene,3884291,3885239,gene,-1,948,spsJ
8367,CDS,3884291,3885239,CDS,-1,948,spsI
8368,gene,3885238,3885979,gene,-1,741,spsI
8369,CDS,3885238,3885979,CDS,-1,741,spsG
8370,gene,3886003,3887023,gene,-1,1020,spsG
8371,CDS,3886003,3887023,CDS,-1,1020,spsF
8372,gene,3887025,3887748,gene,-1,723,spsF
8373,CDS,3887025,3887748,CDS,-1,723,spsE
8374,gene,3887740,3888862,gene,-1,1122,spsE
8375,CDS,3887740,3888862,CDS,-1,1122,spsD
8376,gene,3888861,3889731,gene,-1,870,spsD
8377,CDS,3888861,3889731,CDS,-1,870,spsC
8378,gene,3889731,3890901,gene,-1,1170,spsC
8379,CDS,3889731,3890901,CDS,-1,1170,spsB
8381,CDS,3890921,3892346,CDS,-1,1425,spsA
8380,gene,3890921,3892346,gene,-1,1425,spsB
8382,gene,3892350,3893121,gene,-1,771,spsA
8383,CDS,3892350,3893121,CDS,-1,771,gerQ
8384,gene,3893440,3893986,gene,1,546,gerQ
8385,CDS,3893440,3893986,CDS,1,546,ywdK
8386,gene,3894029,3894401,gene,-1,372,ywdK
8387,CDS,3894029,3894401,CDS,-1,372,ywdJ
8389,CDS,3894462,3895785,CDS,-1,1323,ywdI
8388,gene,3894462,3895785,gene,-1,1323,ywdJ
8390,gene,3895804,3896122,gene,-1,318,ywdI
8391,CDS,3895804,3896122,CDS,-1,318,ywdH
8392,gene,3896289,3897660,gene,1,1371,ywdH
8393,CDS,3896289,3897660,CDS,1,1371,ung
8394,gene,3897684,3898362,gene,-1,678,ung
8395,CDS,3897684,3898362,CDS,-1,678,ywdF
8397,CDS,3898375,3899182,CDS,-1,807,ywdE
8396,gene,3898375,3899182,gene,-1,807,ywdF
8399,CDS,3899271,3899805,CDS,-1,534,ywdD
8398,gene,3899271,3899805,gene,-1,534,ywdE
8400,gene,3899852,3900488,gene,-1,636,ywdD
8401,CDS,3899852,3900488,CDS,-1,636,ywzG
8402,gene,3900480,3900819,gene,-1,339,ywzG
8403,CDS,3900480,3900819,CDS,-1,339,pdxK
8404,gene,3900962,3901778,gene,1,816,pdxK
8405,CDS,3900962,3901778,CDS,1,816,ywdA
8406,gene,3901867,3902116,gene,-1,249,ywdA
8407,CDS,3901867,3902116,CDS,-1,249,sacA
8409,CDS,3902209,3903649,CDS,-1,1440,sacP
8408,gene,3902209,3903649,gene,-1,1440,sacA
8410,gene,3903645,3905031,gene,-1,1386,sacP
8411,CDS,3903645,3905031,CDS,-1,1386,nirC
8412,gene,3905332,3906103,gene,1,771,nirC
8413,CDS,3905332,3906103,CDS,1,771,sacT
8414,gene,3906141,3906972,gene,-1,831,sacT
8415,CDS,3906141,3906972,CDS,-1,831,ywcI
8417,CDS,3907011,3907314,CDS,-1,303,vpr
8416,gene,3907011,3907314,gene,-1,303,ywcI
8418,gene,3907843,3910264,gene,1,2421,vpr
8419,CDS,3907843,3910264,CDS,1,2421,ywcH
8420,gene,3910301,3911303,gene,-1,1002,ywcH
8421,CDS,3910301,3911303,CDS,-1,1002,nfrAA
8422,gene,3911476,3912226,gene,-1,750,nfrAA
8423,CDS,3911476,3912226,CDS,-1,750,rodA
8424,gene,3912331,3913513,gene,-1,1182,rodA
8425,CDS,3912331,3913513,CDS,-1,1182,ywcE
8426,gene,3914008,3914272,gene,1,264,ywcE
8427,CDS,3914008,3914272,CDS,1,264,qoxD
8428,gene,3914314,3914689,gene,-1,375,qoxD
8429,CDS,3914314,3914689,CDS,-1,375,qoxC
8430,gene,3914690,3915305,gene,-1,615,qoxC
8431,CDS,3914690,3915305,CDS,-1,615,qoxB
8433,CDS,3915318,3917268,CDS,-1,1950,qoxA
8432,gene,3915318,3917268,gene,-1,1950,qoxB
8434,gene,3917295,3918261,gene,-1,966,qoxA
8435,CDS,3917295,3918261,CDS,-1,966,ywzA
8436,gene,3918776,3919022,gene,1,246,ywzA
8437,CDS,3918776,3919022,CDS,1,246,galT
8438,gene,3919092,3920634,gene,-1,1542,galT
8439,CDS,3919092,3920634,CDS,-1,1542,galK
8440,gene,3920637,3921810,gene,-1,1173,galK
8441,CDS,3920637,3921810,CDS,-1,1173,ywcD
8442,gene,3921890,3922274,gene,-1,384,ywcD
8443,CDS,3921890,3922274,CDS,-1,384,slrC
8444,gene,3922291,3922963,gene,-1,672,slrC
8445,CDS,3922291,3922963,CDS,-1,672,slrA
8446,gene,3923318,3923477,gene,1,159,slrA
8447,CDS,3923318,3923477,CDS,1,159,vbfB
8449,CDS,3923919,3924228,CDS,1,309,vbfA
8448,gene,3923919,3924228,gene,1,309,vbfB
8450,gene,3924224,3925766,gene,1,1542,vbfA
8451,CDS,3924224,3925766,CDS,1,1542,ywbO
8452,gene,3925796,3926399,gene,-1,603,ywbO
8453,CDS,3925796,3926399,CDS,-1,603,efeB
8454,gene,3926681,3927932,gene,-1,1251,efeB
8455,CDS,3926681,3927932,CDS,-1,1251,efeM
8457,CDS,3927950,3929108,CDS,-1,1158,efeU
8456,gene,3927950,3929108,gene,-1,1158,efeM
8458,gene,3929104,3930550,gene,-1,1446,efeU
8459,CDS,3929104,3930550,CDS,-1,1446,thiE
8460,gene,3930706,3931375,gene,-1,669,thiE
8461,CDS,3930706,3931375,CDS,-1,669,thiM
8462,gene,3931371,3932190,gene,-1,819,thiM
8463,CDS,3931371,3932190,CDS,-1,819,cidR
8464,gene,3932197,3933103,gene,-1,906,cidR
8465,CDS,3932197,3933103,CDS,-1,906,cidA
8467,CDS,3933208,3933595,CDS,1,387,cidB
8466,gene,3933208,3933595,gene,1,387,cidA
8468,gene,3933576,3934254,gene,1,678,cidB
8469,CDS,3933576,3934254,CDS,1,678,ywbF
8470,gene,3934357,3935557,gene,1,1200,ywbF
8471,CDS,3934357,3935557,CDS,1,1200,ywbE
8472,gene,3935590,3935788,gene,1,198,ywbE
8473,CDS,3935590,3935788,CDS,1,198,rlmI
8475,CDS,3935823,3937014,CDS,-1,1191,glxA
8474,gene,3935823,3937014,gene,-1,1191,rlmI
8476,gene,3937134,3937515,gene,1,381,glxA
8477,CDS,3937134,3937515,CDS,1,381,ywbB
8478,gene,3937552,3938230,gene,-1,678,ywbB
8479,CDS,3937552,3938230,CDS,-1,678,ywbA
8480,gene,3938306,3939641,gene,-1,1335,ywbA
8481,CDS,3938306,3939641,CDS,-1,1335,epr
8482,gene,3939868,3941806,gene,1,1938,epr
8483,CDS,3939868,3941806,CDS,1,1938,sacX
8485,CDS,3942233,3943613,CDS,1,1380,sacY
8484,gene,3942233,3943613,gene,1,1380,sacX
8486,gene,3943666,3944509,gene,1,843,sacY
8487,CDS,3943666,3944509,CDS,1,843,gspA
8488,gene,3944559,3945420,gene,-1,861,gspA
8489,CDS,3944559,3945420,CDS,-1,861,ywaF
8490,gene,3945529,3946243,gene,-1,714,ywaF
8491,CDS,3945529,3946243,CDS,-1,714,tyrZR
8492,gene,3946393,3946909,gene,1,516,tyrZR
8493,CDS,3946393,3946909,CDS,1,516,tboYB
8494,gene,3946909,3947116,gene,1,207,tboYB
8495,misc_RNA,3946909,3947116,else,1,207,tyrZ
8496,gene,3947157,3948399,gene,1,1242,tyrZ
8497,CDS,3947157,3948399,CDS,1,1242,eapD
8498,gene,3948554,3949922,gene,1,1368,eapD
8499,CDS,3948554,3949922,CDS,1,1368,relQ
8500,gene,3949951,3950584,gene,-1,633,relQ
8501,CDS,3949951,3950584,CDS,-1,633,menA
8502,gene,3950725,3951661,gene,-1,936,menA
8503,CDS,3950725,3951661,CDS,-1,936,BSU_38495
8505,CDS,3951823,3951958,CDS,-1,135,ywzH
8504,gene,3951823,3951958,gene,-1,135,BSU_38495
8506,gene,3952107,3952257,gene,1,150,ywzH
8507,CDS,3952107,3952257,CDS,1,150,dltA
8508,gene,3952274,3953786,gene,1,1512,dltA
8509,CDS,3952274,3953786,CDS,1,1512,dltB
8510,gene,3953782,3954970,gene,1,1188,dltB
8511,CDS,3953782,3954970,CDS,1,1188,dltC
8512,gene,3954986,3955223,gene,1,237,dltC
8513,CDS,3954986,3955223,CDS,1,237,dltD
8514,gene,3955222,3956401,gene,1,1179,dltD
8515,CDS,3955222,3956401,CDS,1,1179,dltE
8516,gene,3956491,3957250,gene,1,759,dltE
8517,CDS,3956491,3957250,CDS,1,759,ilvK
8518,gene,3957390,3958482,gene,1,1092,ilvK
8519,CDS,3957390,3958482,CDS,1,1092,licH
8521,CDS,3958515,3959844,CDS,-1,1329,licA
8520,gene,3958515,3959844,gene,-1,1329,licH
8522,gene,3959840,3960173,gene,-1,333,licA
8523,CDS,3959840,3960173,CDS,-1,333,licC
8524,gene,3960191,3961550,gene,-1,1359,licC
8525,CDS,3960191,3961550,CDS,-1,1359,licB
8526,gene,3961565,3961874,gene,-1,309,licB
8527,CDS,3961565,3961874,CDS,-1,309,licR
8529,CDS,3962002,3963928,CDS,-1,1926,yxzF
8528,gene,3962002,3963928,gene,-1,1926,licR
8530,gene,3964090,3964249,gene,-1,159,yxzF
8531,CDS,3964090,3964249,CDS,-1,159,aag
8532,gene,3964277,3964868,gene,-1,591,aag
8533,CDS,3964277,3964868,CDS,-1,591,katX
8534,gene,3964996,3966640,gene,1,1644,katX
8535,CDS,3964996,3966640,CDS,1,1644,yxlH
8536,gene,3966744,3967947,gene,1,1203,yxlH
8537,CDS,3966744,3967947,CDS,1,1203,yxlG
8539,CDS,3967943,3968720,CDS,-1,777,yxlF
8538,gene,3967943,3968720,gene,-1,777,yxlG
8540,gene,3968716,3969604,gene,-1,888,yxlF
8541,CDS,3968716,3969604,CDS,-1,888,yxlE
8542,gene,3969610,3969799,gene,-1,189,yxlE
8543,CDS,3969610,3969799,CDS,-1,189,yxlD
8544,gene,3969795,3970002,gene,-1,207,yxlD
8545,CDS,3969795,3970002,CDS,-1,207,yxlC
8547,CDS,3969998,3970319,CDS,-1,321,sigY
8546,gene,3969998,3970319,gene,-1,321,yxlC
8548,gene,3970311,3970848,gene,-1,537,sigY
8549,CDS,3970311,3970848,CDS,-1,537,yxlA
8550,gene,3971059,3972433,gene,1,1374,yxlA
8551,CDS,3971059,3972433,CDS,1,1374,nnrA
8552,gene,3972447,3973278,gene,-1,831,nnrA
8553,CDS,3972447,3973278,CDS,-1,831,cydD
8554,gene,3973363,3975091,gene,-1,1728,cydD
8555,CDS,3973363,3975091,CDS,-1,1728,cydC
8557,CDS,3975087,3976791,CDS,-1,1704,cydB
8556,gene,3975087,3976791,gene,-1,1704,cydC
8558,gene,3976790,3977807,gene,-1,1017,cydB
8559,CDS,3976790,3977807,CDS,-1,1017,cydA
8560,gene,3977790,3979197,gene,-1,1407,cydA
8561,CDS,3977790,3979197,CDS,-1,1407,cimH
8562,gene,3979752,3981105,gene,1,1353,cimH
8563,CDS,3979752,3981105,CDS,1,1353,yxkI
8564,gene,3981226,3982915,gene,1,1689,yxkI
8565,CDS,3981226,3982915,CDS,1,1689,yxzE
8566,gene,3982972,3983173,gene,1,201,yxzE
8567,CDS,3982972,3983173,CDS,1,201,yxkH
8568,gene,3983186,3984026,gene,-1,840,yxkH
8569,CDS,3983186,3984026,CDS,-1,840,msmX
8570,gene,3984132,3985230,gene,-1,1098,msmX
8571,CDS,3984132,3985230,CDS,-1,1098,yxkF
8572,gene,3985350,3986244,gene,-1,894,yxkF
8573,CDS,3985350,3986244,CDS,-1,894,aldY
8575,CDS,3986427,3987885,CDS,1,1458,gdnE
8574,gene,3986427,3987885,gene,1,1458,aldY
8576,gene,3987926,3988763,gene,-1,837,gdnE
8577,CDS,3987926,3988763,CDS,-1,837,gdwB
8578,gene,3988839,3988942,gene,-1,103,gdwB
8579,misc_RNA,3988839,3988942,else,-1,103,yxkC
8580,gene,3989330,3989873,gene,1,543,yxkC
8581,CDS,3989330,3989873,CDS,1,543,galE
8583,CDS,3989947,3990967,CDS,-1,1020,yxkA
8582,gene,3989947,3990967,gene,-1,1020,galE
8584,gene,3991081,3991588,gene,-1,507,yxkA
8585,CDS,3991081,3991588,CDS,-1,507,yxjO
8586,gene,3991717,3992593,gene,1,876,yxjO
8587,CDS,3991717,3992593,CDS,1,876,yxjN
8588,gene,3992670,3993144,gene,1,474,yxjN
8589,CDS,3992670,3993144,CDS,1,474,yxjM
8591,CDS,3993161,3994382,CDS,1,1221,yxjL
8590,gene,3993161,3994382,gene,1,1221,yxjM
8593,CDS,3994368,3995025,CDS,1,657,pepT
8592,gene,3994368,3995025,gene,1,657,yxjL
8594,gene,3995074,3996307,gene,1,1233,pepT
8595,CDS,3995074,3996307,CDS,1,1233,yxjJ
8596,gene,3996828,3997092,gene,1,264,yxjJ
8597,CDS,3996828,3997092,CDS,1,264,yxjI
8598,gene,3997220,3997709,gene,1,489,yxjI
8599,CDS,3997220,3997709,CDS,1,489,mswI
8600,gene,3997774,3997881,gene,1,107,mswI
8601,misc_RNA,3997774,3997881,else,1,107,yxjH
8603,CDS,3997963,3999097,CDS,1,1134,mswJ
8602,gene,3997963,3999097,gene,1,1134,yxjH
8604,gene,3999165,3999272,gene,1,107,mswJ
8605,misc_RNA,3999165,3999272,else,1,107,yxjG
8606,gene,3999349,4000486,gene,1,1137,yxjG
8607,CDS,3999349,4000486,CDS,1,1137,yxjF
8608,gene,4000538,4001312,gene,-1,774,yxjF
8609,CDS,4000538,4001312,CDS,-1,774,scoB
8611,CDS,4001328,4001979,CDS,-1,651,scoA
8610,gene,4001328,4001979,gene,-1,651,scoB
8612,gene,4001975,4002692,gene,-1,717,scoA
8613,CDS,4001975,4002692,CDS,-1,717,yxjC
8614,gene,4002715,4004134,gene,-1,1419,yxjC
8615,CDS,4002715,4004134,CDS,-1,1419,rlmA
8616,gene,4004287,4005136,gene,-1,849,rlmA
8617,CDS,4004287,4005136,CDS,-1,849,gswB
8618,gene,4005522,4005625,gene,1,103,gswB
8619,misc_RNA,4005522,4005625,else,1,103,nupG
8620,gene,4005751,4006945,gene,1,1194,nupG
8621,CDS,4005751,4006945,CDS,1,1194,yxiTc
8622,gene,4006986,4007415,gene,-1,429,yxiTc
8623,misc_feature,4006986,4007415,else,-1,429,yxiTn
8624,gene,4007415,4007658,gene,-1,243,yxiTn
8625,misc_feature,4007415,4007658,else,-1,243,yxiS
8627,CDS,4007802,4008093,CDS,-1,291,katE
8626,gene,4007802,4008093,gene,-1,291,yxiS
8628,gene,4008142,4010203,gene,-1,2061,katE
8629,CDS,4008142,4010203,CDS,-1,2061,citH
8630,gene,4010403,4011684,gene,1,1281,citH
8631,CDS,4010403,4011684,CDS,1,1281,bglS
8632,gene,4011841,4012570,gene,-1,729,bglS
8633,CDS,4011841,4012570,CDS,-1,729,licT
8635,CDS,4012865,4013699,CDS,-1,834,yxiP
8634,gene,4012865,4013699,gene,-1,834,licT
8636,gene,4013794,4014475,gene,-1,681,yxiP
8637,CDS,4013794,4014475,CDS,-1,681,yxiO
8638,gene,4014681,4015968,gene,1,1287,yxiO
8639,CDS,4014681,4015968,CDS,1,1287,deaD
8640,gene,4015986,4017426,gene,-1,1440,deaD
8641,CDS,4015986,4017426,CDS,-1,1440,yxiM
8642,gene,4017507,4018656,gene,-1,1149,yxiM
8643,CDS,4017507,4018656,CDS,-1,1149,yxzI
8645,misc_feature,4018785,4018974,else,-1,189,yxzJ
8644,gene,4018785,4018974,gene,-1,189,yxzI
8647,CDS,4019004,4019136,CDS,-1,132,yxiK
8646,gene,4019004,4019136,gene,-1,132,yxzJ
8648,gene,4019147,4019609,gene,-1,462,yxiK
8649,CDS,4019147,4019609,CDS,-1,462,yxiJ
8650,gene,4019624,4019921,gene,-1,297,yxiJ
8651,CDS,4019624,4019921,CDS,-1,297,yxiI
8652,gene,4019948,4020437,gene,-1,489,yxiI
8653,CDS,4019948,4020437,CDS,-1,489,yxzG
8654,gene,4020454,4020907,gene,-1,453,yxzG
8655,CDS,4020454,4020907,CDS,-1,453,yxiH
8657,CDS,4020976,4021306,CDS,-1,330,yxiG
8656,gene,4020976,4021306,gene,-1,330,yxiH
8658,gene,4021428,4021845,gene,-1,417,yxiG
8659,CDS,4021428,4021845,CDS,-1,417,yxzC
8660,gene,4021895,4022264,gene,-1,369,yxzC
8661,CDS,4021895,4022264,CDS,-1,369,yxiF
8662,gene,4022257,4022728,gene,-1,471,yxiF
8663,CDS,4022257,4022728,CDS,-1,471,wapI
8665,CDS,4023053,4023482,CDS,-1,429,wapA
8664,gene,4023053,4023482,gene,-1,429,wapI
8666,gene,4023543,4030548,gene,-1,7005,wapA
8667,CDS,4023543,4030548,CDS,-1,7005,yxxF
8668,gene,4030709,4031645,gene,-1,936,yxxF
8669,CDS,4030709,4031645,CDS,-1,936,yxiE
8670,gene,4031796,4032243,gene,-1,447,yxiE
8671,CDS,4031796,4032243,CDS,-1,447,bglH
8672,gene,4032345,4033755,gene,-1,1410,bglH
8673,CDS,4032345,4033755,CDS,-1,1410,bglP
8674,gene,4033777,4035607,gene,-1,1830,bglP
8675,CDS,4033777,4035607,CDS,-1,1830,yxxE
8676,gene,4035989,4036298,gene,-1,309,yxxE
8677,CDS,4035989,4036298,CDS,-1,309,rtbE
8678,gene,4036343,4036787,gene,-1,444,rtbE
8679,CDS,4036343,4036787,CDS,-1,444,rtbD
8680,gene,4036783,4038493,gene,-1,1710,rtbD
8681,CDS,4036783,4038493,CDS,-1,1710,yxiC
8683,CDS,4038512,4038782,CDS,-1,270,yxiB
8682,gene,4038512,4038782,gene,-1,270,yxiC
8684,gene,4038793,4039159,gene,-1,366,yxiB
8685,CDS,4038793,4039159,CDS,-1,366,abnB
8686,gene,4039465,4040875,gene,-1,1410,abnB
8687,CDS,4039465,4040875,CDS,-1,1410,yxzL
8688,gene,4041008,4041173,gene,-1,165,yxzL
8689,CDS,4041008,4041173,CDS,-1,165,hutP
8691,CDS,4041491,4041938,CDS,1,447,hutH
8690,gene,4041491,4041938,gene,1,447,hutP
8692,gene,4042050,4043577,gene,1,1527,hutH
8693,CDS,4042050,4043577,CDS,1,1527,hutU
8694,gene,4043573,4045232,gene,1,1659,hutU
8695,CDS,4043573,4045232,CDS,1,1659,hutI
8696,gene,4045244,4046510,gene,1,1266,hutI
8697,CDS,4045244,4046510,CDS,1,1266,hutG
8698,gene,4046502,4047462,gene,1,960,hutG
8699,CDS,4046502,4047462,CDS,1,960,hutM
8701,CDS,4047537,4048965,CDS,1,1428,pdp
8700,gene,4047537,4048965,gene,1,1428,hutM
8702,gene,4049008,4050310,gene,-1,1302,pdp
8703,CDS,4049008,4050310,CDS,-1,1302,nupC
8704,gene,4050339,4051521,gene,-1,1182,nupC
8705,CDS,4050339,4051521,CDS,-1,1182,deoC
8706,gene,4051601,4052273,gene,-1,672,deoC
8707,CDS,4051601,4052273,CDS,-1,672,deoR
8708,gene,4052378,4053320,gene,-1,942,deoR
8709,CDS,4052378,4053320,CDS,-1,942,yxxB
8710,gene,4053453,4054281,gene,-1,828,yxxB
8711,CDS,4053453,4054281,CDS,-1,828,yxeR
8712,gene,4054353,4055466,gene,-1,1113,yxeR
8713,CDS,4054353,4055466,CDS,-1,1113,yxeQ
8714,gene,4055535,4056873,gene,-1,1338,yxeQ
8715,CDS,4055535,4056873,CDS,-1,1338,sndB
8717,CDS,4056869,4058012,CDS,-1,1143,yxeO
8716,gene,4056869,4058012,gene,-1,1143,sndB
8719,CDS,4058028,4058778,CDS,-1,750,yxeN
8718,gene,4058028,4058778,gene,-1,750,yxeO
8720,gene,4058790,4059465,gene,-1,675,yxeN
8721,CDS,4058790,4059465,CDS,-1,675,yxeM
8722,gene,4059487,4060282,gene,-1,795,yxeM
8723,CDS,4059487,4060282,CDS,-1,795,snaB
8724,gene,4060306,4060804,gene,-1,498,snaB
8725,CDS,4060306,4060804,CDS,-1,498,yxeK
8726,gene,4060817,4062143,gene,-1,1326,yxeK
8727,CDS,4060817,4062143,CDS,-1,1326,yxeJ
8728,gene,4062328,4062556,gene,-1,228,yxeJ
8729,CDS,4062328,4062556,CDS,-1,228,yxeI
8730,gene,4062542,4063529,gene,-1,987,yxeI
8731,CDS,4062542,4063529,CDS,-1,987,hadM
8732,gene,4063683,4064496,gene,-1,813,hadM
8733,CDS,4063683,4064496,CDS,-1,813,yxeG
8734,gene,4064535,4065093,gene,-1,558,yxeG
8735,CDS,4064535,4065093,CDS,-1,558,yxeF
8737,CDS,4065073,4065508,CDS,-1,435,cotNE
8736,gene,4065073,4065508,gene,-1,435,yxeF
8738,gene,4065596,4065962,gene,1,366,cotNE
8739,CDS,4065596,4065962,CDS,1,366,yxeD
8740,gene,4066209,4066563,gene,1,354,yxeD
8741,CDS,4066209,4066563,CDS,1,354,yxeC
8742,gene,4066606,4067005,gene,-1,399,yxeC
8743,CDS,4066606,4067005,CDS,-1,399,frxB
8745,CDS,4067182,4068148,CDS,1,966,yxeA
8744,gene,4067182,4068148,gene,1,966,frxB
8746,gene,4068188,4068536,gene,-1,348,yxeA
8747,CDS,4068188,4068536,CDS,-1,348,tpeM
8748,gene,4068549,4070418,gene,-1,1869,tpeM
8749,CDS,4068549,4070418,CDS,-1,1869,tpeL
8750,gene,4070392,4071166,gene,-1,774,tpeL
8751,CDS,4070392,4071166,CDS,-1,774,tpeK
8753,CDS,4071309,4072287,CDS,-1,978,tpeJ
8752,gene,4071309,4072287,gene,-1,978,tpeK
8755,CDS,4072283,4072973,CDS,-1,690,iolJ
8754,gene,4072283,4072973,gene,-1,690,tpeJ
8756,gene,4073080,4073953,gene,-1,873,iolJ
8757,CDS,4073080,4073953,CDS,-1,873,iolI
8758,gene,4073973,4074810,gene,-1,837,iolI
8759,CDS,4073973,4074810,CDS,-1,837,iolH
8760,gene,4074895,4075765,gene,-1,870,iolH
8761,CDS,4074895,4075765,CDS,-1,870,iolG
8762,gene,4075784,4076819,gene,-1,1035,iolG
8763,CDS,4075784,4076819,CDS,-1,1035,iolF
8765,CDS,4076841,4078158,CDS,-1,1317,iolE
8764,gene,4076841,4078158,gene,-1,1317,iolF
8766,gene,4078172,4079066,gene,-1,894,iolE
8767,CDS,4078172,4079066,CDS,-1,894,iolD
8768,gene,4079082,4080996,gene,-1,1914,iolD
8769,CDS,4079082,4080996,CDS,-1,1914,iolC
8770,gene,4081028,4082006,gene,-1,978,iolC
8771,CDS,4081028,4082006,CDS,-1,978,iolB
8773,CDS,4082029,4082845,CDS,-1,816,iolA
8772,gene,4082029,4082845,gene,-1,816,iolB
8774,gene,4082919,4084383,gene,-1,1464,iolA
8775,CDS,4082919,4084383,CDS,-1,1464,iolR
8776,gene,4084798,4085554,gene,1,756,iolR
8777,CDS,4084798,4085554,CDS,1,756,iolS
8778,gene,4085607,4086540,gene,1,933,iolS
8779,CDS,4085607,4086540,CDS,1,933,yxcE
8780,gene,4086801,4087452,gene,1,651,yxcE
8781,CDS,4086801,4087452,CDS,1,651,yxcD
8782,gene,4087455,4087764,gene,1,309,yxcD
8783,CDS,4087455,4087764,CDS,1,309,csbC
8784,gene,4088001,4089387,gene,1,1386,csbC
8785,CDS,4088001,4089387,CDS,1,1386,htpG
8786,gene,4089428,4091309,gene,-1,1881,htpG
8787,CDS,4089428,4091309,CDS,-1,1881,yxcA
8789,CDS,4091476,4091728,CDS,-1,252,yxbG
8788,gene,4091476,4091728,gene,-1,252,yxcA
8790,gene,4091844,4092666,gene,1,822,yxbG
8791,CDS,4091844,4092666,CDS,1,822,yxbF
8792,gene,4092694,4093837,gene,-1,1143,yxbF
8793,CDS,4092694,4093837,CDS,-1,1143,aldX
8794,gene,4093979,4095317,gene,1,1338,aldX
8795,CDS,4093979,4095317,CDS,1,1338,yxbD
8796,gene,4095355,4095835,gene,-1,480,yxbD
8797,CDS,4095355,4095835,CDS,-1,480,yxbC
8798,gene,4095914,4096907,gene,-1,993,yxbC
8799,CDS,4095914,4096907,CDS,-1,993,srlX
8800,gene,4096996,4097409,gene,1,413,srlX
8801,misc_RNA,4096996,4097409,else,1,413,yxbB
8802,gene,4097415,4098150,gene,1,735,yxbB
8803,CDS,4097415,4098150,CDS,1,735,yxbA
8804,gene,4098149,4098419,gene,1,270,yxbA
8805,CDS,4098149,4098419,CDS,1,270,yxnB
8807,CDS,4098422,4098905,CDS,1,483,asnH
8806,gene,4098422,4098905,gene,1,483,yxnB
8808,gene,4098925,4101169,gene,1,2244,asnH
8809,CDS,4098925,4101169,CDS,1,2244,yxaM
8810,gene,4101165,4102365,gene,1,1200,yxaM
8811,CDS,4101165,4102365,CDS,1,1200,yxaL
8812,gene,4102428,4103661,gene,-1,1233,yxaL
8813,CDS,4102428,4103661,CDS,-1,1233,yxaJ
8815,CDS,4103761,4104187,CDS,-1,426,yxaI
8814,gene,4103761,4104187,gene,-1,426,yxaJ
8816,gene,4104443,4104899,gene,1,456,yxaI
8817,CDS,4104443,4104899,CDS,1,456,yxaH
8818,gene,4104928,4106137,gene,-1,1209,yxaH
8819,CDS,4104928,4106137,CDS,-1,1209,qdoI
8820,gene,4106244,4107258,gene,-1,1014,qdoI
8821,CDS,4106244,4107258,CDS,-1,1014,qdoR
8823,CDS,4107351,4107927,CDS,-1,576,yxnA
8822,gene,4107351,4107927,gene,-1,576,qdoR
8825,CDS,4108057,4109128,CDS,1,1071,yxaD
8824,gene,4108057,4109128,gene,1,1071,yxnA
8826,gene,4109184,4109616,gene,-1,432,yxaD
8827,CDS,4109184,4109616,CDS,-1,432,yxzK
8828,gene,4109842,4110247,gene,1,405,yxzK
8829,CDS,4109842,4110247,CDS,1,405,yxaC
8830,gene,4110216,4110909,gene,1,693,yxaC
8831,CDS,4110216,4110909,CDS,1,693,yxaB
8832,gene,4110948,4111980,gene,-1,1032,yxaB
8833,CDS,4110948,4111980,CDS,-1,1032,glxK
8835,CDS,4112072,4113221,CDS,-1,1149,gntR
8834,gene,4112072,4113221,gene,-1,1149,glxK
8836,gene,4113416,4114148,gene,1,732,gntR
8837,CDS,4113416,4114148,CDS,1,732,gntK
8838,gene,4114140,4115682,gene,1,1542,gntK
8839,CDS,4114140,4115682,CDS,1,1542,gntP
8840,gene,4115710,4117057,gene,1,1347,gntP
8841,CDS,4115710,4117057,CDS,1,1347,gntZ
8843,CDS,4117079,4118486,CDS,1,1407,ahpC
8842,gene,4117079,4118486,gene,1,1407,gntZ
8844,gene,4118949,4119513,gene,1,564,ahpC
8845,CDS,4118949,4119513,CDS,1,564,ahpF
8846,gene,4119526,4121056,gene,1,1530,ahpF
8847,CDS,4119526,4121056,CDS,1,1530,bglA
8848,gene,4121165,4122605,gene,-1,1440,bglA
8849,CDS,4121165,4122605,CDS,-1,1440,ptsJ
8850,gene,4122618,4122849,gene,-1,231,ptsJ
8851,CDS,4122618,4122849,CDS,-1,231,yydK
8852,gene,4123192,4123903,gene,1,711,yydK
8853,CDS,4123192,4123903,CDS,1,711,yyzN
8854,gene,4123930,4124089,gene,1,159,yyzN
8855,CDS,4123930,4124089,CDS,1,159,liaM
8856,gene,4124219,4124942,gene,-1,723,liaM
8857,CDS,4124219,4124942,CDS,-1,723,liaL
8859,CDS,4124962,4125592,CDS,-1,630,liaK
8858,gene,4124962,4125592,gene,-1,630,liaL
8860,gene,4125741,4126500,gene,-1,759,liaK
8861,CDS,4125741,4126500,CDS,-1,759,liaE
8862,gene,4126480,4127440,gene,-1,960,liaE
8863,CDS,4126480,4127440,CDS,-1,960,liaD
8864,gene,4127497,4127647,gene,-1,150,liaD
8865,CDS,4127497,4127647,CDS,-1,150,fbp
8866,gene,4128118,4130044,gene,1,1926,fbp
8867,CDS,4128118,4130044,CDS,1,1926,yydD
8868,gene,4130577,4132338,gene,-1,1761,yydD
8869,CDS,4130577,4132338,CDS,-1,1761,yydC
8870,gene,4132337,4132736,gene,-1,399,yydC
8871,CDS,4132337,4132736,CDS,-1,399,yydB
8872,gene,4132728,4134174,gene,-1,1446,yydB
8873,CDS,4132728,4134174,CDS,-1,1446,rlmH
8875,CDS,4134435,4134915,CDS,-1,480,yyzF
8874,gene,4134435,4134915,gene,-1,480,rlmH
8876,gene,4134995,4135166,gene,-1,171,yyzF
8877,CDS,4134995,4135166,CDS,-1,171,yycS
8878,gene,4135350,4135764,gene,1,414,yycS
8879,CDS,4135350,4135764,CDS,1,414,yycR
8880,gene,4135797,4137024,gene,-1,1227,yycR
8881,CDS,4135797,4137024,CDS,-1,1227,yyzG
8883,CDS,4137086,4137257,CDS,-1,171,yycQ
8882,gene,4137086,4137257,gene,-1,171,yyzG
8884,gene,4137361,4137610,gene,-1,249,yycQ
8885,CDS,4137361,4137610,CDS,-1,249,yycP
8886,gene,4137625,4138789,gene,-1,1164,yycP
8887,CDS,4137625,4138789,CDS,-1,1164,yycO
8888,gene,4138799,4139537,gene,-1,738,yycO
8889,CDS,4138799,4139537,CDS,-1,738,yycN
8890,gene,4139678,4140149,gene,-1,471,yycN
8891,CDS,4139678,4140149,CDS,-1,471,rapG
8893,CDS,4140259,4141357,CDS,1,1098,phrG
8892,gene,4140259,4141357,gene,1,1098,rapG
8894,gene,4141357,4141474,gene,1,117,phrG
8895,CDS,4141357,4141474,CDS,1,117,argI
8896,gene,4141710,4142601,gene,-1,891,argI
8897,CDS,4141710,4142601,CDS,-1,891,rocE
8898,gene,4142674,4144078,gene,-1,1404,rocE
8899,CDS,4142674,4144078,CDS,-1,1404,rocD
8901,CDS,4144300,4145506,CDS,-1,1206,rocR
8900,gene,4144300,4145506,gene,-1,1206,rocD
8902,gene,4145746,4147132,gene,1,1386,rocR
8903,CDS,4145746,4147132,CDS,1,1386,yyzO
8904,gene,4147113,4147302,gene,-1,189,yyzO
8905,misc_feature,4147113,4147302,else,-1,189,BSU_40358
8906,gene,4147418,4147547,gene,-1,129,BSU_40358
8907,CDS,4147418,4147547,CDS,-1,129,htrC
8908,gene,4147566,4148769,gene,-1,1203,htrC
8909,CDS,4147566,4148769,CDS,-1,1203,walJ
8911,CDS,4148850,4149645,CDS,-1,795,walI
8910,gene,4148850,4149645,gene,-1,795,walJ
8912,gene,4149666,4150509,gene,-1,843,walI
8913,CDS,4149666,4150509,CDS,-1,843,walH
8914,gene,4150495,4151863,gene,-1,1368,walH
8915,CDS,4150495,4151863,CDS,-1,1368,walK
8916,gene,4151852,4153688,gene,-1,1836,walK
8917,CDS,4151852,4153688,CDS,-1,1836,walR
8918,gene,4153695,4154403,gene,-1,708,walR
8919,CDS,4153695,4154403,CDS,-1,708,trnY-Phe
8920,gene,4154786,4154859,gene,-1,73,trnY-Phe
8921,tRNA,4154786,4154859,else,-1,73,trnY-Asp
8922,gene,4154894,4154971,gene,-1,77,trnY-Asp
8923,tRNA,4154894,4154971,else,-1,77,trnY-Glu
8924,gene,4155052,4155124,gene,-1,72,trnY-Glu
8925,tRNA,4155052,4155124,else,-1,72,trnY-Lys
8926,gene,4155133,4155209,gene,-1,76,trnY-Lys
8927,tRNA,4155133,4155209,else,-1,76,purA
8929,CDS,4155432,4156725,CDS,-1,1293,yycE
8928,gene,4155432,4156725,gene,-1,1293,purA
8930,gene,4156930,4157350,gene,-1,420,yycE
8931,CDS,4156930,4157350,CDS,-1,420,dnaC
8932,gene,4157470,4158835,gene,-1,1365,dnaC
8933,CDS,4157470,4158835,CDS,-1,1365,yycD
8934,gene,4159004,4159205,gene,1,201,yycD
8935,CDS,4159004,4159205,CDS,1,201,yyzB
8936,gene,4159252,4159456,gene,-1,204,yyzB
8937,CDS,4159252,4159456,CDS,-1,204,yycC
8938,gene,4159576,4159717,gene,1,141,yycC
8939,CDS,4159576,4159717,CDS,1,141,yycB
8940,gene,4159789,4160998,gene,1,1209,yycB
8941,CDS,4159789,4160998,CDS,1,1209,yycA
8942,gene,4161102,4163160,gene,1,2058,yycA
8943,CDS,4161102,4163160,CDS,1,2058,rplI
8945,CDS,4163196,4163646,CDS,-1,450,gdpP
8944,gene,4163196,4163646,gene,-1,450,rplI
8946,gene,4163642,4165622,gene,-1,1980,gdpP
8947,CDS,4163642,4165622,CDS,-1,1980,yybS
8948,gene,4165658,4166588,gene,-1,930,yybS
8949,CDS,4165658,4166588,CDS,-1,930,yyzH
8950,gene,4166814,4166964,gene,-1,150,yyzH
8951,CDS,4166814,4166964,CDS,-1,150,cotF
8953,CDS,4167109,4167592,CDS,1,483,hypR
8952,gene,4167109,4167592,gene,1,483,cotF
8954,gene,4167621,4167999,gene,-1,378,hypR
8955,CDS,4167621,4167999,CDS,-1,378,ppaC
8956,gene,4168203,4169133,gene,1,930,ppaC
8957,CDS,4168203,4169133,CDS,1,930,yybP
8958,gene,4169165,4169612,gene,-1,447,yybP
8959,CDS,4169165,4169612,CDS,-1,447,mswM
8960,gene,4169801,4169919,gene,-1,118,mswM
8961,misc_RNA,4169801,4169919,else,-1,118,yybO
8963,CDS,4170044,4171352,CDS,1,1308,yyzI
8962,gene,4170044,4171352,gene,1,1308,yybO
8964,gene,4171395,4171635,gene,-1,240,yyzI
8965,misc_feature,4171395,4171635,else,-1,240,yyzJ
8966,gene,4171624,4171789,gene,-1,165,yyzJ
8967,misc_feature,4171624,4171789,else,-1,165,BSU_40576
8968,gene,4171800,4171986,gene,-1,186,BSU_40576
8969,CDS,4171800,4171986,CDS,-1,186,yyzK
8971,misc_feature,4172258,4172405,else,-1,147,yyzL
8970,gene,4172258,4172405,gene,-1,147,yyzK
8972,gene,4172386,4172536,gene,-1,150,yyzL
8973,misc_feature,4172386,4172536,else,-1,150,yybN
8974,gene,4173113,4173551,gene,1,438,yybN
8975,CDS,4173113,4173551,CDS,1,438,yybM
8976,gene,4173664,4174420,gene,1,756,yybM
8977,CDS,4173664,4174420,CDS,1,756,yybL
8978,gene,4174409,4175120,gene,1,711,yybL
8979,CDS,4174409,4175120,CDS,1,711,yybK
8981,CDS,4175116,4175872,CDS,1,756,yybJ
8980,gene,4175116,4175872,gene,1,756,yybK
8982,gene,4175868,4176525,gene,1,657,yybJ
8983,CDS,4175868,4176525,CDS,1,657,ictI
8984,gene,4176899,4177688,gene,-1,789,ictI
8985,CDS,4176899,4177688,CDS,-1,789,yybH
8986,gene,4177755,4178145,gene,-1,390,yybH
8987,CDS,4177755,4178145,CDS,-1,390,yybG
8988,gene,4178290,4179130,gene,1,840,yybG
8989,CDS,4178290,4179130,CDS,1,840,yybF
8990,gene,4179162,4180377,gene,-1,1215,yybF
8991,CDS,4179162,4180377,CDS,-1,1215,yybE
8992,gene,4180563,4181442,gene,1,879,yybE
8993,CDS,4180563,4181442,CDS,1,879,yybD
8994,gene,4181455,4181899,gene,1,444,yybD
8995,CDS,4181455,4181899,CDS,1,444,yybC
8997,CDS,4181981,4182461,CDS,1,480,yybB
8996,gene,4181981,4182461,gene,1,480,yybC
8999,CDS,4182635,4183298,CDS,-1,663,yybA
8998,gene,4182635,4183298,gene,-1,663,yybB
9000,gene,4183444,4183897,gene,-1,453,yybA
9001,CDS,4183444,4183897,CDS,-1,453,yyaT
9002,gene,4184016,4184463,gene,1,447,yyaT
9003,CDS,4184016,4184463,CDS,1,447,yyaS
9004,gene,4184459,4185065,gene,1,606,yyaS
9005,CDS,4184459,4185065,CDS,1,606,yyaR
9006,gene,4185159,4185681,gene,-1,522,yyaR
9007,CDS,4185159,4185681,CDS,-1,522,yyaQ
9008,gene,4186091,4186448,gene,1,357,yyaQ
9009,CDS,4186091,4186448,CDS,1,357,yyaP
9010,gene,4186607,4187174,gene,1,567,yyaP
9011,CDS,4186607,4187174,CDS,1,567,tetB
9012,gene,4187680,4189057,gene,-1,1377,tetB
9013,CDS,4187680,4189057,CDS,-1,1377,tetL
9015,CDS,4189090,4189153,CDS,-1,63,yyaO
9014,gene,4189090,4189153,gene,-1,63,tetL
9016,gene,4189405,4189645,gene,1,240,yyaO
9017,CDS,4189405,4189645,CDS,1,240,yyaN
9018,gene,4189795,4190212,gene,1,417,yyaN
9019,CDS,4189795,4190212,CDS,1,417,yyaM
9020,gene,4190208,4191126,gene,1,918,yyaM
9021,CDS,4190208,4191126,CDS,1,918,yyaL
9023,CDS,4191197,4193267,CDS,1,2070,yyaK
9022,gene,4191197,4193267,gene,1,2070,yyaL
9024,gene,4193263,4194163,gene,-1,900,yyaK
9025,CDS,4193263,4194163,CDS,-1,900,yyaJ
9026,gene,4194388,4195744,gene,1,1356,yyaJ
9027,CDS,4194388,4195744,CDS,1,1356,maa
9028,gene,4195777,4196332,gene,-1,555,maa
9029,CDS,4195777,4196332,CDS,-1,555,yyaH
9030,gene,4196349,4196730,gene,-1,381,yyaH
9031,CDS,4196349,4196730,CDS,-1,381,ccpB
9033,CDS,4196785,4197721,CDS,-1,936,exoA
9032,gene,4196785,4197721,gene,-1,936,ccpB
9034,gene,4197779,4198538,gene,-1,759,exoA
9035,CDS,4197779,4198538,CDS,-1,759,rpsR
9036,gene,4198602,4198842,gene,-1,240,rpsR
9037,CDS,4198602,4198842,CDS,-1,240,ssbA
9038,gene,4198885,4199404,gene,-1,519,ssbA
9039,CDS,4198885,4199404,CDS,-1,519,rpsF
9041,CDS,4199444,4199732,CDS,-1,288,engD
9040,gene,4199444,4199732,gene,-1,288,rpsF
9042,gene,4199842,4200943,gene,-1,1101,engD
9043,CDS,4199842,4200943,CDS,-1,1101,yyaE
9044,gene,4201069,4203073,gene,-1,2004,yyaE
9045,CDS,4201069,4203073,CDS,-1,2004,yyzM
9046,gene,4203123,4203330,gene,-1,207,yyzM
9047,CDS,4203123,4203330,CDS,-1,207,yyaD
9048,gene,4203423,4204440,gene,-1,1017,yyaD
9049,CDS,4203423,4204440,CDS,-1,1017,sprC
9051,CDS,4204899,4205517,CDS,1,618,parB
9050,gene,4204899,4205517,gene,1,618,sprC
9052,gene,4205555,4206404,gene,-1,849,parB
9053,CDS,4205555,4206404,CDS,-1,849,parA
9054,gene,4206396,4207158,gene,-1,762,parA
9055,CDS,4206396,4207158,CDS,-1,762,yyaB
9056,gene,4207405,4207846,gene,1,441,yyaB
9057,CDS,4207405,4207846,CDS,1,441,nocA
9058,gene,4207896,4208748,gene,-1,852,nocA
9059,CDS,4207896,4208748,CDS,-1,852,rsmG
9060,gene,4208869,4209589,gene,-1,720,rsmG
9061,CDS,4208869,4209589,CDS,-1,720,trmF
9062,gene,4209602,4211489,gene,-1,1887,trmF
9063,CDS,4209602,4211489,CDS,-1,1887,mnmE
9064,gene,4211509,4212889,gene,-1,1380,mnmE
9065,CDS,4211509,4212889,CDS,-1,1380,jag
9066,gene,4213199,4213826,gene,-1,627,jag
9067,CDS,4213199,4213826,CDS,-1,627,oxaAA
9068,gene,4213822,4214608,gene,-1,786,oxaAA
9069,CDS,4213822,4214608,CDS,-1,786,rnpA
9070,gene,4214752,4215103,gene,-1,351,rnpA
9071,CDS,4214752,4215103,CDS,-1,351,rpmH
9072,gene,4215254,4215389,gene,-1,135,rpmH
9073,CDS,4215254,4215389,CDS,-1,135,
